//MAP CONVERTED BY dmm2tgm.py THIS HEADER COMMENT PREVENTS RECONVERSION, DO NOT REMOVE
"a" = (
/turf/simulated/floor/circuit,
/area/station/turret_protected/ai)
"b" = (
/obj/machinery/turret,
/turf/simulated/floor/black,
/area/station/turret_protected/ai)
"c" = (
/obj/machinery/light{
	dir = 8;
	layer = 9.1;
	pixel_x = -10
	},
/obj/machinery/recharge_station,
/mob/living/silicon/hivebot/eyebot,
/turf/simulated/floor/circuit,
/area/station/turret_protected/ai)
"d" = (
/obj/machinery/power/apc/autoname_north,
/obj/cable{
	icon_state = "0-8"
	},
/obj/cable{
	icon_state = "0-2"
	},
/obj/cable{
	icon_state = "0-4"
	},
/turf/simulated/floor/black,
/area/station/turret_protected/ai)
"f" = (
/obj/cable{
	icon_state = "0-8"
	},
/obj/cable{
	icon_state = "0-2"
	},
/obj/machinery/door/poddoor/pyro/shutters{
	density = 0;
	dir = 5;
	icon_state = "pdoor0";
	id = "ai_core";
	name = "AI Core Shield";
	opacity = 0
	},
/obj/mapping_helper/wingrille_spawn/auto/reinforced,
/turf/simulated/floor/circuit/off,
/area/station/turret_protected/ai)
"g" = (
/obj/cable{
	icon_state = "4-8"
	},
/turf/simulated/floor/black,
/area/station/turret_protected/ai)
"h" = (
/obj/cable,
/obj/machinery/door/poddoor/pyro/shutters{
	density = 0;
	dir = 10;
	icon_state = "pdoor0";
	id = "ai_core";
	name = "AI Core Shield";
	opacity = 0
	},
/obj/mapping_helper/wingrille_spawn/auto/reinforced,
/turf/simulated/floor/circuit/off,
/area/station/turret_protected/ai)
"i" = (
/obj/cable{
	icon_state = "1-6"
	},
/turf/simulated/floor/black,
/area/station/turret_protected/ai)
"j" = (
/obj/cable{
	icon_state = "0-2"
	},
/obj/cable{
	icon_state = "0-4"
	},
/obj/machinery/door/poddoor/pyro/shutters{
	density = 0;
	dir = 9;
	icon_state = "pdoor0";
	id = "ai_core";
	name = "AI Core Shield";
	opacity = 0
	},
/obj/mapping_helper/wingrille_spawn/auto/reinforced,
/turf/simulated/floor/circuit/off,
/area/station/turret_protected/ai)
"k" = (
/obj/machinery/light{
	dir = 8;
	layer = 9.1;
	pixel_x = -10
	},
/obj/landmark/start/job/cyborg,
/turf/simulated/floor/circuit,
/area/station/turret_protected/ai)
"l" = (
/obj/machinery/door/airlock/pyro/command/alt{
	dir = 1
	},
/obj/mapping_helper/access/ai_upload,
/obj/cable{
	icon_state = "1-2"
	},
/obj/mapping_helper/firedoor_spawn,
/turf/simulated/floor/black,
/area/station/turret_protected/ai)
"n" = (
/obj/cable{
	icon_state = "5-8"
	},
/obj/machinery/turret,
/turf/simulated/floor/black,
/area/station/turret_protected/ai)
"p" = (
/obj/machinery/camera/directional/north{
	pixel_x = 10
	},
/turf/simulated/floor/circuit,
/area/station/turret_protected/ai)
"q" = (
/obj/cable{
	icon_state = "1-2"
	},
/turf/simulated/floor/circuit,
/area/station/turret_protected/ai)
"r" = (
/obj/cable{
	dir = null
	},
/obj/cable{
	icon_state = "0-2"
	},
/obj/cable{
	icon_state = "0-4"
	},
/turf/simulated/floor/black,
/area/station/turret_protected/ai)
"s" = (
/obj/machinery/light_switch/directional/east,
/turf/simulated/floor/circuit,
/area/station/turret_protected/ai)
"u" = (
/obj/machinery/door/airlock/pyro/command/alt{
	dir = 4
	},
/obj/cable{
	icon_state = "4-8"
	},
/obj/mapping_helper/access/ai_upload,
/obj/mapping_helper/firedoor_spawn,
/turf/simulated/floor/black,
/area/station/turret_protected/ai)
"w" = (
/obj/machinery/light{
	dir = 4;
	layer = 9.1;
	pixel_x = 10
	},
/obj/machinery/recharge_station,
/mob/living/silicon/hivebot/eyebot,
/turf/simulated/floor/circuit,
/area/station/turret_protected/ai)
"y" = (
/obj/cable{
	icon_state = "4-8"
	},
/turf/simulated/floor/circuit,
/area/station/turret_protected/ai)
"A" = (
/obj/machinery/firealarm/directional/east,
/turf/simulated/floor/circuit,
/area/station/turret_protected/ai)
"B" = (
/obj/cable{
	icon_state = "4-10"
	},
/turf/simulated/floor/black,
/area/station/turret_protected/ai)
"E" = (
/obj/machinery/ai_status_display{
	pixel_y = 28
	},
/turf/simulated/floor/circuit,
/area/station/turret_protected/ai)
"G" = (
/obj/machinery/camera/directional/south{
	pixel_x = -10
	},
/turf/simulated/floor/circuit,
/area/station/turret_protected/ai)
"H" = (
/obj/cable{
	icon_state = "6-8"
	},
/turf/simulated/floor/black,
/area/station/turret_protected/ai)
"I" = (
/obj/cable,
/obj/machinery/door/poddoor/pyro/shutters{
	density = 0;
	dir = 6;
	icon_state = "pdoor0";
	id = "ai_core";
	name = "AI Core Shield";
	opacity = 0
	},
/obj/mapping_helper/wingrille_spawn/auto/reinforced,
/turf/simulated/floor/circuit/off,
/area/station/turret_protected/ai)
"J" = (
/obj/machinery/light{
	dir = 4;
	layer = 9.1;
	pixel_x = 10
	},
/obj/landmark/start/job/cyborg,
/turf/simulated/floor/circuit,
/area/station/turret_protected/ai)
"K" = (
/obj/cable,
/obj/cable{
	icon_state = "0-2"
	},
/obj/machinery/door/poddoor/pyro/shutters{
	density = 0;
	dir = 4;
	icon_state = "pdoor0";
	id = "ai_core";
	name = "AI Core Shield";
	opacity = 0
	},
/obj/mapping_helper/wingrille_spawn/auto/reinforced,
/turf/simulated/floor/circuit/off,
/area/station/turret_protected/ai)
"L" = (
/turf/simulated/floor/black,
/area/station/turret_protected/ai)
"N" = (
/obj/cable{
	icon_state = "0-2"
	},
/obj/cable,
/obj/cable{
	icon_state = "0-8"
	},
/turf/simulated/floor/black,
/area/station/turret_protected/ai)
"O" = (
/obj/cable{
	icon_state = "2-5"
	},
/turf/simulated/floor/black,
/area/station/turret_protected/ai)
"P" = (
/turf/simulated/wall/auto/reinforced/supernorn/colored/blue,
/area/station/turret_protected/ai)
"Q" = (
/obj/machinery/power/data_terminal,
/obj/landmark/start/job/AI,
/obj/cable,
/obj/item/device/radio/intercom/AI{
	dir = 8;
	layer = 5
	},
/obj/machinery/camera/directional/south{
	pixel_x = -10
	},
/obj/machinery/door_control{
	id = "ai_core";
	name = "AI Core Shield";
	pixel_y = -21;
	dir = 1;
	pixel_x = -1
	},
/turf/simulated/floor/circuit,
/area/station/turret_protected/ai)
"R" = (
/obj/cable{
	icon_state = "1-10"
	},
/turf/simulated/floor/black,
/area/station/turret_protected/ai)
"S" = (
/obj/cable{
	icon_state = "2-9"
	},
/turf/simulated/floor/black,
/area/station/turret_protected/ai)
"T" = (
/obj/cable{
	icon_state = "0-2"
	},
/obj/cable{
	icon_state = "0-8"
	},
/obj/cable,
/obj/cable{
	icon_state = "0-4"
	},
/turf/simulated/floor/black,
/area/station/turret_protected/ai)
"U" = (
/obj/machinery/turretid/ai_chamber{
	pixel_y = 30
	},
/turf/simulated/floor/circuit,
/area/station/turret_protected/ai)
"W" = (
/obj/cable{
	icon_state = "4-9"
	},
/obj/machinery/turret,
/turf/simulated/floor/black,
/area/station/turret_protected/ai)
"X" = (
/obj/mapping_helper/access/ai_upload,
/obj/machinery/door/airlock/pyro/glass/command{
	name = "AI Core"
	},
/obj/cable{
	icon_state = "0-8"
	},
/obj/cable,
/obj/cable{
	icon_state = "0-2"
	},
/obj/cable{
	icon_state = "0-4"
	},
/obj/machinery/door/poddoor/pyro/shutters{
	density = 0;
	icon_state = "pdoor0";
	id = "ai_core";
	name = "AI Core Shield";
	opacity = 0
	},
/turf/simulated/floor/circuit/off,
/area/station/turret_protected/ai)
"Y" = (
/obj/machinery/door/airlock/pyro/command/alt{
	dir = 4
	},
/obj/mapping_helper/access/ai_upload,
/obj/cable{
	icon_state = "4-8"
	},
/obj/mapping_helper/firedoor_spawn,
/turf/simulated/floor/black,
/area/station/turret_protected/ai)
"Z" = (
/obj/machinery/firealarm/directional/west,
/turf/simulated/floor/circuit,
/area/station/turret_protected/ai)

(1,1,1) = {"
P
P
P
P
u
P
P
P
P
"}
(2,1,1) = {"
P
k
a
a
g
Z
a
c
P
"}
(3,1,1) = {"
P
a
b
O
N
i
L
G
P
"}
(4,1,1) = {"
P
U
B
j
K
h
W
a
P
"}
(5,1,1) = {"
l
q
T
X
Q
P
d
q
l
"}
(6,1,1) = {"
P
E
H
f
K
I
n
a
P
"}
(7,1,1) = {"
P
p
b
S
r
R
L
a
P
"}
(8,1,1) = {"
P
J
a
s
y
A
a
w
P
"}
(9,1,1) = {"
P
P
P
P
Y
P
P
P
P
"}
