//MAP CONVERTED BY dmm2tgm.py THIS HEADER COMMENT PREVENTS RECONVERSION, DO NOT REMOVE
"a" = (
/obj/fluid_spawner{
	amount = 200;
	delay = 200
	},
/obj/sea_plant/tubesponge/small,
/turf/simulated/floor/sand,
/area/station/crew_quarters/aquarium)
"d" = (
/obj/fluid_spawner{
	amount = 200;
	delay = 200
	},
/obj/cable{
	icon_state = "1-2"
	},
/turf/simulated/floor,
/area/station/crew_quarters/aquarium)
"k" = (
/obj/fluid_spawner{
	amount = 200;
	delay = 200
	},
/mob/living/critter/small_animal/large_jellyfish/grabby,
/turf/simulated/floor/sand,
/area/station/crew_quarters/aquarium)
"m" = (
/obj/fluid_spawner{
	amount = 200;
	delay = 200
	},
/obj/cable{
	icon_state = "4-8"
	},
/turf/simulated/floor,
/area/station/crew_quarters/aquarium)
"q" = (
/obj/fluid_spawner{
	amount = 200;
	delay = 200
	},
/obj/sea_plant/seaweed,
/turf/simulated/floor/sand,
/area/station/crew_quarters/aquarium)
"r" = (
/obj/fluid_spawner{
	amount = 200;
	delay = 200
	},
/obj/item/rubberduck{
	pixel_y = 6
	},
/turf/simulated/floor/sand,
/area/station/crew_quarters/aquarium)
"s" = (
/obj/fluid_spawner{
	amount = 200;
	delay = 200
	},
/obj/submachine/weapon_vendor/fishing/portable,
/turf/simulated/floor/sand,
/area/station/crew_quarters/aquarium)
"t" = (
/obj/fluid_spawner{
	amount = 200;
	delay = 200
	},
/obj/sea_plant/bulbous,
/turf/simulated/floor/sand,
/area/station/crew_quarters/aquarium)
"v" = (
/obj/fluid_spawner{
	amount = 200;
	delay = 200
	},
/obj/sea_plant/kelp,
/turf/simulated/floor/sand,
/area/station/crew_quarters/aquarium)
"w" = (
/obj/fluid_spawner{
	amount = 200;
	delay = 200
	},
/obj/submachine/fishing_upload_terminal/portable,
/turf/simulated/floor/sand,
/area/station/crew_quarters/aquarium)
"y" = (
/obj/fluid_spawner{
	amount = 200;
	delay = 200
	},
/mob/living/critter/aquatic/fish/nautilus,
/turf/simulated/floor/sand,
/area/station/crew_quarters/aquarium)
"z" = (
/obj/fluid_spawner{
	amount = 200;
	delay = 200
	},
/obj/item/inner_tube/random,
/turf/simulated/floor/sand,
/area/station/crew_quarters/aquarium)
"C" = (
/obj/mapping_helper/wingrille_spawn/auto,
/turf/simulated/floor/plating,
/area/station/crew_quarters/aquarium)
"D" = (
/obj/fluid_spawner{
	amount = 200;
	delay = 200
	},
/turf/simulated/floor/sand,
/area/station/crew_quarters/aquarium)
"G" = (
/obj/fluid_spawner{
	amount = 200;
	delay = 200
	},
/obj/machinery/light/small/floor/blueish,
/obj/cable{
	icon_state = "4-8"
	},
/turf/simulated/floor,
/area/station/crew_quarters/aquarium)
"H" = (
/obj/machinery/door/airlock/pyro/glass{
	dir = 4
	},
/obj/forcefield/energyshield/perma/doorlink{
	dir = 8
	},
/obj/machinery/power/apc/autoname_north,
/obj/cable{
	icon_state = "0-8"
	},
/obj/cable{
	icon_state = "0-4"
	},
/turf/simulated/floor,
/area/station/crew_quarters/aquarium)
"M" = (
/obj/fluid_spawner{
	amount = 200;
	delay = 200
	},
/obj/cable{
	icon_state = "4-8"
	},
/obj/cable{
	icon_state = "2-8"
	},
/obj/cable{
	icon_state = "1-8"
	},
/obj/fishing_pool/portable,
/turf/simulated/floor,
/area/station/crew_quarters/aquarium)
"N" = (
/obj/machinery/door/airlock/pyro/glass{
	dir = 4
	},
/obj/forcefield/energyshield/perma/doorlink{
	dir = 8
	},
/obj/cable{
	icon_state = "0-4"
	},
/obj/cable{
	icon_state = "0-8"
	},
/turf/simulated/floor,
/area/station/crew_quarters/aquarium)
"O" = (
/obj/fluid_spawner{
	amount = 200;
	delay = 200
	},
/mob/living/critter/aquatic/fish/jellyfish,
/turf/simulated/floor/sand,
/area/station/crew_quarters/aquarium)
"R" = (
/obj/fluid_spawner{
	amount = 200;
	delay = 200
	},
/obj/machinery/light/small/floor/blueish,
/obj/cable{
	icon_state = "1-2"
	},
/turf/simulated/floor,
/area/station/crew_quarters/aquarium)
"S" = (
/obj/machinery/door/airlock/pyro/glass,
/obj/forcefield/energyshield/perma/doorlink,
/obj/cable{
	icon_state = "0-2"
	},
/obj/cable,
/turf/simulated/floor,
/area/station/crew_quarters/aquarium)
"V" = (
/turf/simulated/wall/auto/supernorn/colored,
/area/station/crew_quarters/aquarium)
"X" = (
/obj/fluid_spawner{
	amount = 200;
	delay = 200
	},
/mob/living/critter/aquatic/fish/clown{
	desc = "Sounded like a good name. Looks good on it too. Yep.";
	name = "Oscar"
	},
/turf/simulated/floor/sand,
/area/station/crew_quarters/aquarium)
"Y" = (
/obj/machinery/door/airlock/pyro/glass,
/obj/forcefield/energyshield/perma/doorlink,
/obj/cable,
/obj/cable{
	icon_state = "0-2"
	},
/turf/simulated/floor,
/area/station/crew_quarters/aquarium)
"Z" = (
/obj/fluid_spawner{
	amount = 200;
	delay = 200
	},
/obj/sea_plant/tubesponge,
/turf/simulated/floor/sand,
/area/station/crew_quarters/aquarium)

(1,1,1) = {"
V
C
C
C
N
C
C
C
V
"}
(2,1,1) = {"
C
X
v
t
m
D
O
Z
C
"}
(3,1,1) = {"
C
a
q
z
G
D
y
D
C
"}
(4,1,1) = {"
C
v
D
O
m
D
v
D
C
"}
(5,1,1) = {"
Y
d
R
d
M
d
R
d
S
"}
(6,1,1) = {"
C
D
Z
D
m
X
t
D
C
"}
(7,1,1) = {"
C
D
k
D
G
D
r
s
C
"}
(8,1,1) = {"
C
q
X
v
m
q
a
w
C
"}
(9,1,1) = {"
V
C
C
C
H
C
C
C
V
"}
