//MAP CONVERTED BY dmm2tgm.py THIS HEADER COMMENT PREVENTS RECONVERSION, DO NOT REMOVE
"aw" = (
/obj/cable{
	icon_state = "1-2"
	},
/obj/disposalpipe/segment,
/turf/simulated/floor/carpet/blue/fancy/innercorner/omni,
/area/station/bridge)
"be" = (
/obj/table/nanotrasen/auto,
/obj/item/paper_bin{
	pixel_x = -2;
	pixel_y = 9
	},
/obj/item/pen/fancy,
/turf/simulated/floor/carpet/blue/fancy/innercorner/east,
/area/station/bridge)
"bj" = (
/obj/cable{
	icon_state = "4-8"
	},
/obj/cable{
	icon_state = "2-8"
	},
/turf/simulated/floor/carpet/blue/fancy/edge/north,
/area/station/bridge)
"bH" = (
/obj/mapping_helper/wingrille_spawn/auto/reinforced/crystal,
/obj/machinery/door/poddoor/pyro/shutters{
	density = 0;
	dir = 4;
	icon_state = "pdoor0";
	layer = 4;
	opacity = 0
	},
/obj/mapping_helper/button/area,
/obj/window_blinds/cog2/right{
	dir = 4
	},
/turf/simulated/floor/plating,
/area/station/bridge)
"cn" = (
/obj/table/nanotrasen/auto,
/obj/machinery/phone,
/obj/disposalpipe/segment{
	dir = 4
	},
/turf/simulated/floor/carpet/blue/fancy/innercorner/se,
/area/station/bridge)
"dP" = (
/obj/cable{
	icon_state = "4-8"
	},
/obj/machinery/light/small/floor/cool,
/obj/cable{
	icon_state = "2-8"
	},
/turf/simulated/floor/carpet/blue/fancy/edge/ne,
/area/station/bridge)
"fg" = (
/obj/cable{
	icon_state = "1-2"
	},
/obj/disposalpipe/segment,
/turf/simulated/wall/false_wall/reinforced{
	icon = 'icons/turf/walls/supernorn/reinforced/blue.dmi';
	icon_state = "norn-12";
	can_be_auto = 0
	},
/area/station/bridge)
"fo" = (
/obj/storage/crate/radio,
/turf/simulated/floor/darkblueblack{
	dir = 4
	},
/area/station/bridge)
"gz" = (
/obj/stool/chair/comfy/red{
	dir = 4
	},
/obj/landmark/start/job/head_of_security,
/obj/machinery/camera/directional/south,
/turf/simulated/floor/carpet/blue/fancy/edge/west,
/area/station/bridge)
"gL" = (
/obj/machinery/computer3/generic/bank_data{
	dir = 4
	},
/obj/cable{
	icon_state = "0-4"
	},
/obj/machinery/power/data_terminal,
/turf/simulated/floor/darkblueblack{
	dir = 8
	},
/area/station/bridge)
"hl" = (
/obj/cable{
	icon_state = "1-10"
	},
/turf/simulated/floor/black,
/area/station/bridge)
"im" = (
/obj/cable{
	icon_state = "6-9"
	},
/obj/cable{
	icon_state = "1-6"
	},
/obj/cable{
	icon_state = "6-8"
	},
/turf/simulated/floor/black,
/area/station/bridge)
"iR" = (
/obj/cable{
	icon_state = "1-2"
	},
/obj/machinery/light/small/floor/cool,
/turf/simulated/floor/black,
/area/station/bridge)
"kb" = (
/obj/cable{
	icon_state = "1-2"
	},
/obj/machinery/light/small/floor/cool,
/obj/disposalpipe/segment,
/turf/simulated/floor/carpet/blue/fancy/innercorner/omni,
/area/station/bridge)
"km" = (
/obj/machinery/light/small/floor,
/obj/cable{
	icon_state = "2-8"
	},
/obj/cable{
	icon_state = "1-8"
	},
/obj/cable{
	icon_state = "2-4"
	},
/obj/cable{
	icon_state = "1-4"
	},
/obj/stool/chair/comfy,
/obj/cable{
	icon_state = "1-5"
	},
/obj/cable{
	icon_state = "1-9"
	},
/obj/landmark/start/job/captain,
/turf/simulated/floor/carpet/blue/fancy/edge/north,
/area/station/bridge)
"kF" = (
/obj/mapping_helper/wingrille_spawn/auto/reinforced/crystal,
/obj/machinery/door/poddoor/pyro/shutters{
	density = 0;
	dir = 4;
	icon_state = "pdoor0";
	layer = 4;
	opacity = 0
	},
/obj/mapping_helper/button/area,
/obj/window_blinds/cog2/left{
	dir = 8
	},
/turf/simulated/floor/plating,
/area/station/bridge)
"lw" = (
/obj/table/nanotrasen/auto,
/obj/item/storage/box/trackimp_kit{
	pixel_x = 3;
	pixel_y = 11
	},
/turf/simulated/floor/carpet/blue/fancy/innercorner/east,
/area/station/bridge)
"lS" = (
/obj/cable{
	icon_state = "4-8"
	},
/turf/simulated/floor/black,
/area/station/bridge)
"nx" = (
/obj/mapping_helper/wingrille_spawn/auto/reinforced/crystal,
/obj/machinery/door/poddoor/pyro/shutters{
	density = 0;
	dir = 4;
	icon_state = "pdoor0";
	layer = 4;
	opacity = 0
	},
/obj/mapping_helper/button/area,
/obj/window_blinds/cog2/left{
	dir = 4
	},
/turf/simulated/floor/plating,
/area/station/bridge)
"pa" = (
/obj/cable{
	icon_state = "4-8"
	},
/obj/machinery/light/small/floor/cool,
/turf/simulated/floor/carpet/blue/fancy/edge/nw,
/area/station/bridge)
"pr" = (
/obj/cable{
	icon_state = "1-2"
	},
/obj/machinery/door/airlock/pyro/command/alt,
/obj/mapping_helper/access/heads,
/obj/mapping_helper/firedoor_spawn,
/obj/machinery/door/poddoor/pyro/shutters{
	density = 0;
	dir = 1;
	icon_state = "pdoor0";
	layer = 4;
	opacity = 0;
	id = "bridge"
	},
/obj/machinery/secscanner{
	pixel_y = 10
	},
/turf/simulated/floor/plating,
/area/station/bridge)
"pS" = (
/obj/machinery/computer3/generic/communications,
/obj/item/device/radio/intercom/security,
/obj/cable{
	icon_state = "0-2"
	},
/obj/machinery/power/data_terminal,
/turf/simulated/floor/darkblueblack{
	dir = 1
	},
/area/station/bridge)
"qI" = (
/obj/stool/chair/comfy/green{
	dir = 4
	},
/obj/landmark/start/job/head_of_personnel,
/obj/disposalpipe/segment{
	dir = 4
	},
/turf/simulated/floor/carpet/blue/fancy/edge/west,
/area/station/bridge)
"rP" = (
/obj/cable{
	icon_state = "4-8"
	},
/obj/machinery/door/poddoor/pyro/shutters{
	density = 0;
	dir = 4;
	icon_state = "pdoor0";
	layer = 4;
	opacity = 0;
	id = "bridge"
	},
/obj/machinery/door/airlock/pyro/command/alt{
	dir = 8
	},
/obj/mapping_helper/access/heads,
/obj/mapping_helper/firedoor_spawn,
/obj/machinery/secscanner{
	dir = 4;
	pixel_x = -20
	},
/turf/simulated/floor/black,
/area/station/bridge)
"sg" = (
/obj/mapping_helper/wingrille_spawn/auto/reinforced/crystal,
/obj/mapping_helper/wingrille_spawn/auto/reinforced/crystal,
/obj/machinery/door/poddoor/pyro/shutters{
	density = 0;
	dir = 4;
	icon_state = "pdoor0";
	layer = 4;
	opacity = 0
	},
/obj/mapping_helper/button/area,
/obj/window_blinds/cog2/left{
	dir = 8
	},
/turf/simulated/floor/plating,
/area/station/bridge)
"uI" = (
/obj/table/nanotrasen/auto,
/obj/machinery/networked/printer{
	name = "Printer - Bridge";
	pixel_y = 5;
	print_id = "Bridge"
	},
/obj/cable,
/obj/machinery/power/data_terminal,
/turf/simulated/floor/carpet{
	dir = 10;
	icon_state = "fblue3"
	},
/area/station/bridge)
"xv" = (
/obj/stool/chair/comfy/yellow{
	dir = 8
	},
/obj/cable{
	icon_state = "1-4"
	},
/obj/landmark/start/job/chief_engineer,
/turf/simulated/floor/carpet/blue/fancy/edge/east,
/area/station/bridge)
"Bz" = (
/obj/cable{
	icon_state = "1-2"
	},
/turf/simulated/floor/black,
/area/station/bridge)
"BN" = (
/turf/simulated/floor/carpet/blue/fancy/edge/west,
/area/station/bridge)
"DN" = (
/obj/shrub,
/obj/machinery/light{
	dir = 1;
	pixel_y = 21
	},
/obj/blind_switch/directional/east{
	pixel_y = -4
	},
/obj/machinery/light_switch/directional/east{
	pixel_y = 6
	},
/turf/simulated/floor/greenblack{
	dir = 5
	},
/area/station/bridge)
"EE" = (
/obj/cable{
	icon_state = "1-6"
	},
/obj/cable{
	icon_state = "6-8"
	},
/turf/simulated/floor/black,
/area/station/bridge)
"Hz" = (
/obj/table/wood/round/auto,
/obj/machinery/coffeemaker/command,
/obj/drink_rack/mug{
	pixel_x = -26
	},
/obj/machinery/light/incandescent/warm,
/turf/simulated/floor/black,
/area/station/bridge)
"Ic" = (
/turf/simulated/wall/auto/reinforced/supernorn/colored/blue,
/area/station/bridge)
"Lk" = (
/obj/cable{
	icon_state = "4-8"
	},
/turf/simulated/floor/carpet/blue/fancy/edge/north,
/area/station/bridge)
"LG" = (
/obj/machinery/computer/general_alert{
	dir = 8
	},
/obj/cable{
	icon_state = "0-8"
	},
/obj/machinery/power/data_terminal,
/turf/simulated/floor/yellowblack{
	dir = 4
	},
/area/station/bridge)
"LZ" = (
/obj/machinery/computer/camera_viewer,
/obj/item/device/radio/intercom/medical,
/obj/cable{
	icon_state = "0-2"
	},
/obj/machinery/power/data_terminal,
/obj/machinery/camera/directional/north{
	pixel_x = 18
	},
/turf/simulated/floor/redblack{
	dir = 1
	},
/area/station/bridge)
"Mr" = (
/obj/machinery/computer3/generic/secure_data{
	dir = 4;
	tag = ""
	},
/obj/cable{
	icon_state = "0-4"
	},
/obj/machinery/power/data_terminal,
/turf/simulated/floor/redblack{
	dir = 8
	},
/area/station/bridge)
"MR" = (
/obj/stool/chair/comfy/purple{
	dir = 8
	},
/obj/cable{
	icon_state = "1-2"
	},
/obj/landmark/start/job/research_director,
/turf/simulated/floor/carpet/blue/fancy/edge/east,
/area/station/bridge)
"MY" = (
/obj/cable{
	icon_state = "1-2"
	},
/obj/table/nanotrasen/auto,
/obj/machinery/shipalert{
	dir = 1
	},
/obj/machinery/door_control/table{
	pixel_x = -15
	},
/obj/mapping_helper/button/area,
/obj/disposalpipe/segment/bent/south,
/turf/simulated/floor/carpet/blue/fancy/innercorner/south,
/area/station/bridge)
"OB" = (
/obj/machinery/chem_dispenser/soda,
/obj/machinery/light{
	dir = 1;
	pixel_y = 21
	},
/obj/machinery/firealarm/directional/west,
/turf/simulated/floor/greenblack{
	dir = 9
	},
/area/station/bridge)
"Rc" = (
/obj/table/nanotrasen/auto,
/turf/simulated/floor/carpet/blue/fancy/innercorner/west,
/area/station/bridge)
"Rs" = (
/obj/cable{
	icon_state = "5-10"
	},
/obj/cable{
	icon_state = "4-10"
	},
/obj/cable{
	icon_state = "1-10"
	},
/turf/simulated/floor/black,
/area/station/bridge)
"RV" = (
/obj/cable{
	icon_state = "4-8"
	},
/obj/machinery/door/poddoor/pyro/shutters{
	density = 0;
	dir = 4;
	icon_state = "pdoor0";
	layer = 4;
	opacity = 0;
	id = "bridge"
	},
/obj/machinery/door/airlock/pyro/command/alt{
	dir = 8
	},
/obj/mapping_helper/access/heads,
/obj/mapping_helper/firedoor_spawn,
/obj/machinery/secscanner{
	dir = 4;
	pixel_x = 20
	},
/turf/simulated/floor/black,
/area/station/bridge)
"Tf" = (
/obj/table/wood/round/auto,
/obj/item/reagent_containers/food/drinks/creamer{
	pixel_x = 6;
	pixel_y = 10
	},
/obj/item/kitchen/food_box/sugar_box,
/turf/simulated/floor/black,
/area/station/bridge)
"TN" = (
/obj/stool/chair/comfy/blue{
	dir = 8
	},
/obj/cable{
	icon_state = "1-2"
	},
/obj/landmark/start/job/medical_director,
/turf/simulated/floor/carpet/blue/fancy/edge/east,
/area/station/bridge)
"Vf" = (
/obj/storage/secure/closet/fridge,
/obj/item/storage/box/donkpocket_kit,
/obj/machinery/light/incandescent/warm,
/obj/machinery/power/apc/autoname_east,
/obj/cable{
	icon_state = "0-8"
	},
/turf/simulated/floor/black,
/area/station/bridge)
"VX" = (
/obj/mapping_helper/wingrille_spawn/auto/reinforced/crystal,
/obj/machinery/door/poddoor/pyro/shutters{
	density = 0;
	dir = 4;
	icon_state = "pdoor0";
	layer = 4;
	opacity = 0
	},
/obj/mapping_helper/button/area,
/obj/window_blinds/cog2/right{
	dir = 8
	},
/turf/simulated/floor/plating,
/area/station/bridge)
"WG" = (
/turf/simulated/floor/black,
/area/station/bridge)
"WI" = (
/obj/table/nanotrasen/auto,
/obj/item/device/radio/intercom/bridge{
	dir = 1
	},
/turf/simulated/floor/carpet/blue/fancy/innercorner/west,
/area/station/bridge)
"Xi" = (
/obj/machinery/computer/ordercomp,
/obj/item/device/radio/intercom/science,
/obj/cable{
	icon_state = "0-2"
	},
/obj/machinery/power/data_terminal,
/turf/simulated/floor/yellowblack{
	dir = 1
	},
/area/station/bridge)
"XB" = (
/obj/disposalpipe/trunk/east,
/obj/machinery/disposal,
/turf/simulated/floor/black,
/area/station/bridge)
"XP" = (
/obj/table/auto,
/obj/machinery/microwave,
/turf/simulated/floor/black,
/area/station/bridge)
"YP" = (
/obj/machinery/computer/announcement/station/bridge,
/obj/item/device/radio/intercom/AI,
/obj/cable{
	icon_state = "0-2"
	},
/obj/machinery/power/data_terminal,
/turf/simulated/floor/darkblueblack{
	dir = 1
	},
/area/station/bridge)

(1,1,1) = {"
Ic
Ic
bH
nx
rP
bH
nx
Ic
Ic
"}
(2,1,1) = {"
Ic
OB
gL
Mr
lS
XB
Tf
Hz
Ic
"}
(3,1,1) = {"
Ic
pS
EE
lS
pa
qI
BN
gz
Ic
"}
(4,1,1) = {"
Ic
YP
Bz
im
Lk
cn
be
lw
Ic
"}
(5,1,1) = {"
pr
Bz
iR
Bz
km
MY
kb
aw
fg
"}
(6,1,1) = {"
Ic
LZ
Bz
Rs
bj
uI
Rc
WI
Ic
"}
(7,1,1) = {"
Ic
Xi
hl
lS
dP
TN
MR
xv
Ic
"}
(8,1,1) = {"
Ic
DN
fo
LG
lS
WG
XP
Vf
Ic
"}
(9,1,1) = {"
Ic
Ic
sg
VX
RV
kF
VX
Ic
Ic
"}
