//MAP CONVERTED BY dmm2tgm.py THIS HEADER COMMENT PREVENTS RECONVERSION, DO NOT REMOVE
"a" = (
/obj/item/clothing/suit/bedsheet/orange,
/obj/stool/bed,
/obj/machinery/light/incandescent/netural{
	dir = 1;
	pixel_y = 24
	},
/turf/simulated/floor/black,
/area/station/security/brig/solitary)
"b" = (
/obj/decal/tile_edge/stripe/extra_big{
	dir = 9;
	icon_state = "xtra_bigstripe-corner2"
	},
/turf/simulated/floor/redblack{
	dir = 1
	},
/area/station/security/brig/cell_block_control)
"d" = (
/obj/storage/secure/crate/weapon/confiscated_items,
/turf/simulated/floor/redblack{
	dir = 9
	},
/area/station/security/brig/cell_block_control)
"e" = (
/obj/machinery/power/apc/autoname_north,
/obj/cable{
	icon_state = "2-8"
	},
/obj/cable{
	icon_state = "0-2"
	},
/obj/machinery/flasher/solitary2/new_walls/west,
/obj/disposalpipe/segment/brig{
	dir = 2;
	icon_state = "pipe-c"
	},
/obj/cable{
	icon_state = "2-4"
	},
/turf/simulated/floor/black,
/area/station/security/brig/solitary2)
"g" = (
/obj/cable{
	icon_state = "2-4"
	},
/obj/cable{
	icon_state = "2-8"
	},
/obj/machinery/door_timer/solitary/new_walls/north{
	dir = 2;
	pixel_x = -7
	},
/obj/machinery/door_timer/solitary2/new_walls/north{
	pixel_x = 8;
	dir = 2
	},
/obj/decal/tile_edge/stripe/extra_big{
	dir = 9;
	icon_state = "xtra_bigstripe-corner2"
	},
/obj/decal/tile_edge/stripe/extra_big{
	dir = 5;
	icon_state = "xtra_bigstripe-corner2"
	},
/obj/machinery/light/incandescent/netural{
	dir = 1;
	pixel_y = 24
	},
/turf/simulated/floor/redblack{
	dir = 1
	},
/area/station/security/brig/cell_block_control)
"h" = (
/turf/simulated/wall/auto/reinforced/supernorn/colored/red,
/area/station/security/brig/solitary)
"k" = (
/obj/storage/closet/wardrobe/orange,
/obj/machinery/light/incandescent/netural{
	dir = 8;
	pixel_x = -12
	},
/turf/simulated/floor/redblack{
	dir = 8
	},
/area/station/security/brig/cell_block_control)
"l" = (
/obj/machinery/computer/camera_viewer{
	dir = 8
	},
/obj/machinery/light_switch/directional/east,
/turf/simulated/floor/redblack{
	dir = 5
	},
/area/station/security/brig/cell_block_control)
"m" = (
/obj/storage/secure/closet/brig_automatic/solitary2,
/turf/simulated/floor/black,
/area/station/security/brig/solitary2)
"n" = (
/obj/machinery/computer3/generic/secure_data{
	dir = 8
	},
/obj/machinery/firealarm/directional/east,
/turf/simulated/floor/redblack{
	dir = 4
	},
/area/station/security/brig/cell_block_control)
"o" = (
/obj/cable{
	icon_state = "4-8"
	},
/turf/simulated/wall/auto/reinforced/supernorn/colored/red,
/area/station/security/brig/solitary2)
"p" = (
/turf/simulated/floor/black,
/area/station/security/brig/cell_block_control)
"q" = (
/obj/machinery/power/apc/autoname_north,
/obj/cable{
	icon_state = "2-4"
	},
/obj/cable{
	icon_state = "0-2"
	},
/obj/machinery/flasher/solitary/new_walls/east,
/obj/disposalpipe/segment/brig{
	dir = 4;
	icon_state = "pipe-c"
	},
/obj/cable{
	icon_state = "2-8"
	},
/turf/simulated/floor/black,
/area/station/security/brig/solitary)
"r" = (
/obj/cable{
	icon_state = "1-2"
	},
/obj/machinery/door/airlock/pyro/security/alt,
/obj/mapping_helper/access/brig,
/obj/mapping_helper/firedoor_spawn,
/obj/machinery/secscanner{
	pixel_y = -10
	},
/turf/simulated/floor/plating,
/area/station/security/brig/cell_block_control)
"t" = (
/obj/machinery/camera/directional/south,
/turf/simulated/floor/black,
/area/station/security/brig/cell_block_control)
"u" = (
/obj/cable{
	icon_state = "4-8"
	},
/turf/simulated/floor/black,
/area/station/security/brig/solitary)
"w" = (
/obj/cable{
	icon_state = "1-2"
	},
/obj/machinery/floorflusher/solitary2,
/obj/disposalpipe/trunk/brig{
	dir = 1
	},
/turf/simulated/floor/black,
/area/station/security/brig/solitary2)
"x" = (
/obj/cable{
	icon_state = "1-8"
	},
/obj/decal/tile_edge/stripe/extra_big{
	dir = 1
	},
/turf/simulated/floor/redblack{
	dir = 1
	},
/area/station/security/brig/cell_block_control)
"y" = (
/obj/mapping_helper/wingrille_spawn/auto/reinforced/crystal,
/obj/cable{
	icon_state = "0-8"
	},
/obj/cable{
	icon_state = "0-4"
	},
/turf/simulated/floor/plating,
/area/station/security/brig/solitary)
"z" = (
/obj/machinery/door/airlock/pyro/glass/security,
/obj/cable{
	icon_state = "1-2"
	},
/obj/cable{
	icon_state = "2-4"
	},
/obj/mapping_helper/access/brig,
/turf/simulated/floor/black,
/area/station/security/brig/solitary2)
"A" = (
/turf/simulated/floor/black,
/area/station/security/brig/solitary2)
"B" = (
/turf/simulated/floor/black,
/area/station/security/brig/solitary)
"C" = (
/obj/storage/closet/wardrobe/orange,
/turf/simulated/floor/redblack{
	dir = 8
	},
/area/station/security/brig/cell_block_control)
"D" = (
/obj/machinery/door/airlock/pyro/glass/security,
/obj/cable{
	icon_state = "1-2"
	},
/obj/cable{
	icon_state = "2-8"
	},
/obj/mapping_helper/access/brig,
/turf/simulated/floor/black,
/area/station/security/brig/solitary)
"E" = (
/obj/submachine/poster_creator{
	dir = 8
	},
/obj/machinery/light/incandescent/netural{
	dir = 4;
	pixel_x = 12
	},
/turf/simulated/floor/redblack{
	dir = 4
	},
/area/station/security/brig/cell_block_control)
"G" = (
/obj/cable{
	icon_state = "4-8"
	},
/turf/simulated/wall/auto/reinforced/supernorn/colored/red,
/area/station/security/brig/solitary)
"H" = (
/obj/mapping_helper/wingrille_spawn/auto/reinforced/crystal,
/obj/cable{
	icon_state = "0-8"
	},
/obj/cable{
	icon_state = "0-4"
	},
/turf/simulated/floor/plating,
/area/station/security/brig/solitary2)
"I" = (
/obj/cable{
	icon_state = "1-2"
	},
/obj/machinery/floorflusher/solitary,
/obj/disposalpipe/trunk/brig{
	dir = 1
	},
/turf/simulated/floor/black,
/area/station/security/brig/solitary)
"J" = (
/obj/stool/bed,
/obj/item/clothing/suit/bedsheet/orange,
/obj/machinery/light_switch/directional/north,
/turf/simulated/floor/black,
/area/station/security/brig/solitary2)
"K" = (
/obj/table/auto,
/obj/machinery/computer3/generic/personal/personel_alt,
/obj/cable{
	icon_state = "0-2"
	},
/obj/machinery/power/data_terminal,
/obj/machinery/light/incandescent/netural{
	dir = 1;
	pixel_y = 24
	},
/turf/simulated/floor/black,
/area/station/security/brig/solitary2)
"L" = (
/obj/storage/secure/closet/brig_automatic/solitary,
/turf/simulated/floor/black,
/area/station/security/brig/solitary)
"M" = (
/obj/cable{
	icon_state = "1-8"
	},
/turf/simulated/floor/black,
/area/station/security/brig/solitary2)
"N" = (
/obj/machinery/camera/directional/east,
/turf/simulated/floor/black,
/area/station/security/brig/solitary2)
"O" = (
/obj/cable{
	icon_state = "1-4"
	},
/obj/decal/tile_edge/stripe/extra_big{
	dir = 1
	},
/turf/simulated/floor/redblack{
	dir = 1
	},
/area/station/security/brig/cell_block_control)
"P" = (
/obj/cable{
	icon_state = "1-2"
	},
/obj/disposalpipe/segment/brig,
/turf/simulated/wall/auto/reinforced/supernorn/colored/red,
/area/station/security/brig/solitary)
"R" = (
/obj/machinery/camera/directional/west,
/obj/cable{
	icon_state = "1-4"
	},
/turf/simulated/floor/black,
/area/station/security/brig/solitary)
"S" = (
/obj/cable{
	icon_state = "1-2"
	},
/obj/disposalpipe/trunk/brig,
/obj/disposaloutlet/north,
/turf/simulated/floor/circuit/red,
/area/station/security/brig/solitary)
"T" = (
/obj/decal/tile_edge/stripe/extra_big{
	dir = 5;
	icon_state = "xtra_bigstripe-corner2"
	},
/turf/simulated/floor/redblack{
	dir = 1
	},
/area/station/security/brig/cell_block_control)
"U" = (
/obj/cable{
	icon_state = "1-4"
	},
/obj/cable{
	icon_state = "1-8"
	},
/obj/disposalpipe/junction/middle/north,
/turf/simulated/wall/auto/reinforced/supernorn/colored/red,
/area/station/security/brig/solitary)
"V" = (
/turf/simulated/wall/auto/reinforced/supernorn/colored/red,
/area/station/security/brig/solitary2)
"W" = (
/obj/cable{
	icon_state = "1-2"
	},
/turf/simulated/floor/black,
/area/station/security/brig/cell_block_control)
"X" = (
/obj/table/auto,
/obj/machinery/computer3/generic/personal/personel_alt,
/obj/cable{
	icon_state = "0-2"
	},
/obj/machinery/power/data_terminal,
/obj/machinery/light_switch/directional/north,
/turf/simulated/floor/black,
/area/station/security/brig/solitary)
"Z" = (
/turf/simulated/wall/auto/reinforced/supernorn/colored/red,
/area/station/security/brig/cell_block_control)

(1,1,1) = {"
h
h
h
h
G
Z
Z
Z
Z
"}
(2,1,1) = {"
h
X
R
L
y
d
k
C
Z
"}
(3,1,1) = {"
h
a
u
B
y
T
p
p
Z
"}
(4,1,1) = {"
h
h
q
I
D
O
p
t
Z
"}
(5,1,1) = {"
S
P
U
h
h
g
W
W
r
"}
(6,1,1) = {"
V
V
e
w
z
x
p
p
Z
"}
(7,1,1) = {"
V
K
M
A
H
b
p
p
Z
"}
(8,1,1) = {"
V
J
N
m
H
l
E
n
Z
"}
(9,1,1) = {"
V
V
V
V
o
Z
Z
Z
Z
"}
