//MAP CONVERTED BY dmm2tgm.py THIS HEADER COMMENT PREVENTS RECONVERSION, DO NOT REMOVE
"a" = (
/obj/machinery/door/airlock/pyro/glass/engineering{
	dir = 4
	},
/obj/mapping_helper/access/cargo,
/obj/mapping_helper/firedoor_spawn,
/obj/cable{
	icon_state = "4-8"
	},
/turf/simulated/floor,
/area/station/quartermaster/cargobay{
	name = "Cargo Primary Endpoint"
	})
"b" = (
/turf/simulated/floor/engine/caution/corner{
	dir = 1
	},
/area/station/quartermaster/cargobay{
	name = "Cargo Primary Endpoint"
	})
"c" = (
/turf/simulated/floor/engine/caution/west,
/area/station/quartermaster/cargobay{
	name = "Cargo Primary Endpoint"
	})
"d" = (
/obj/table/reinforced/auto,
/obj/machinery/door/airlock/pyro/glass/windoor{
	dir = 1
	},
/obj/mapping_helper/access/cargo,
/obj/mapping_helper/firedoor_spawn,
/obj/item/stamp/qm{
	pixel_x = -5
	},
/obj/item/clipboard/with_pen{
	pixel_x = 12
	},
/obj/item/pen{
	pixel_x = 10
	},
/turf/simulated/floor,
/area/station/quartermaster/cargobay{
	name = "Cargo Primary Endpoint"
	})
"e" = (
/obj/cable{
	icon_state = "1-4"
	},
/obj/cable{
	icon_state = "1-8"
	},
/obj/cable{
	icon_state = "1-2"
	},
/turf/simulated/floor,
/area/station/quartermaster/cargobay{
	name = "Cargo Primary Endpoint"
	})
"f" = (
/obj/machinery/door/airlock/pyro/engineering/alt{
	dir = 8
	},
/obj/mapping_helper/access/cargo,
/obj/cable{
	icon_state = "4-8"
	},
/obj/mapping_helper/firedoor_spawn,
/turf/simulated/floor,
/area/station/quartermaster/cargobay{
	name = "Cargo Primary Endpoint"
	})
"g" = (
/obj/storage/secure/closet/engineering/cargo,
/turf/simulated/floor,
/area/station/quartermaster/cargobay{
	name = "Cargo Primary Endpoint"
	})
"h" = (
/turf/simulated/floor/engine/caution/corner{
	dir = 4
	},
/area/station/quartermaster/cargobay{
	name = "Cargo Primary Endpoint"
	})
"i" = (
/obj/machinery/firealarm/directional/west,
/turf/simulated/floor/engine/caution/corner{
	dir = 8
	},
/area/station/quartermaster/cargobay{
	name = "Cargo Primary Endpoint"
	})
"j" = (
/obj/mapping_helper/wingrille_spawn/auto/reinforced,
/turf/simulated/floor,
/area/station/quartermaster/cargobay{
	name = "Cargo Primary Endpoint"
	})
"k" = (
/obj/table/reinforced/auto,
/obj/machinery/door/airlock/pyro/glass/windoor{
	dir = 1
	},
/obj/mapping_helper/access/cargo,
/obj/mapping_helper/firedoor_spawn,
/obj/item/paper_bin,
/turf/simulated/floor,
/area/station/quartermaster/cargobay{
	name = "Cargo Primary Endpoint"
	})
"l" = (
/obj/machinery/camera/directional/south,
/turf/simulated/floor/engine/caution/south,
/area/station/quartermaster/cargobay{
	name = "Cargo Primary Endpoint"
	})
"m" = (
/obj/cable{
	icon_state = "4-8"
	},
/obj/disposalpipe/segment{
	dir = 4
	},
/turf/simulated/floor,
/area/station/quartermaster/cargobay{
	name = "Cargo Primary Endpoint"
	})
"n" = (
/obj/machinery/light/incandescent/netural{
	dir = 8
	},
/obj/storage/secure/closet/engineering/cargo,
/turf/simulated/floor,
/area/station/quartermaster/cargobay{
	name = "Cargo Primary Endpoint"
	})
"o" = (
/obj/machinery/computer/supplycomp,
/obj/machinery/camera/directional/north,
/obj/cable{
	icon_state = "0-2"
	},
/obj/machinery/power/data_terminal,
/turf/simulated/floor,
/area/station/quartermaster/cargobay{
	name = "Cargo Primary Endpoint"
	})
"p" = (
/obj/table/reinforced/auto,
/obj/machinery/door/airlock/pyro/glass/windoor,
/obj/mapping_helper/access/cargo,
/obj/mapping_helper/firedoor_spawn,
/turf/simulated/floor,
/area/station/quartermaster/cargobay{
	name = "Cargo Primary Endpoint"
	})
"q" = (
/obj/machinery/light/incandescent/netural{
	dir = 8
	},
/turf/simulated/floor/engine/caution/corner,
/area/station/quartermaster/cargobay{
	name = "Cargo Primary Endpoint"
	})
"r" = (
/obj/cable{
	icon_state = "4-8"
	},
/obj/decal/tile_edge/stripe/extra_big{
	dir = 1
	},
/turf/simulated/floor,
/area/station/quartermaster/cargobay{
	name = "Cargo Primary Endpoint"
	})
"s" = (
/obj/machinery/computer/barcode/qm/no_belthell,
/obj/machinery/light/incandescent/netural{
	dir = 1
	},
/obj/cable{
	icon_state = "0-2"
	},
/obj/machinery/power/data_terminal,
/turf/simulated/floor,
/area/station/quartermaster/cargobay{
	name = "Cargo Primary Endpoint"
	})
"t" = (
/obj/landmark/start/job/quartermaster,
/obj/machinery/power/apc/autoname_east,
/obj/cable{
	icon_state = "0-8"
	},
/obj/disposalpipe/segment/bent/south,
/turf/simulated/floor,
/area/station/quartermaster/cargobay{
	name = "Cargo Primary Endpoint"
	})
"u" = (
/obj/cable{
	icon_state = "1-2"
	},
/obj/decal/tile_edge/stripe/extra_big{
	dir = 8
	},
/turf/simulated/floor,
/area/station/quartermaster/cargobay{
	name = "Cargo Primary Endpoint"
	})
"v" = (
/obj/cable{
	icon_state = "1-2"
	},
/obj/disposalpipe/segment,
/turf/simulated/floor,
/area/station/quartermaster/cargobay{
	name = "Cargo Primary Endpoint"
	})
"w" = (
/turf/simulated/floor/engine/caution/east,
/area/station/quartermaster/cargobay{
	name = "Cargo Primary Endpoint"
	})
"x" = (
/obj/cable{
	icon_state = "4-8"
	},
/obj/cable{
	icon_state = "1-8"
	},
/turf/simulated/floor,
/area/station/quartermaster/cargobay{
	name = "Cargo Primary Endpoint"
	})
"y" = (
/turf/simulated/floor/engine/caution,
/area/station/quartermaster/cargobay{
	name = "Cargo Primary Endpoint"
	})
"z" = (
/obj/cable{
	icon_state = "1-4"
	},
/obj/decal/tile_edge/stripe/extra_big{
	dir = 5;
	icon_state = "xtra_bigstripe-corner2"
	},
/turf/simulated/floor,
/area/station/quartermaster/cargobay{
	name = "Cargo Primary Endpoint"
	})
"B" = (
/obj/machinery/door/airlock/pyro/engineering/alt,
/obj/mapping_helper/access/cargo,
/obj/cable{
	icon_state = "1-2"
	},
/obj/mapping_helper/firedoor_spawn,
/turf/simulated/floor,
/area/station/quartermaster/cargobay{
	name = "Cargo Primary Endpoint"
	})
"C" = (
/obj/table/reinforced/auto,
/obj/machinery/door/airlock/pyro/glass/windoor,
/obj/mapping_helper/access/cargo,
/obj/mapping_helper/firedoor_spawn,
/obj/machinery/cashreg,
/turf/simulated/floor,
/area/station/quartermaster/cargobay{
	name = "Cargo Primary Endpoint"
	})
"E" = (
/turf/simulated/wall/auto/supernorn/colored/yellow,
/area/station/quartermaster/cargobay{
	name = "Cargo Primary Endpoint"
	})
"F" = (
/obj/cable{
	icon_state = "2-8"
	},
/obj/cable{
	icon_state = "1-2"
	},
/obj/cable{
	icon_state = "2-4"
	},
/obj/disposalpipe/segment/bent/east,
/turf/simulated/floor,
/area/station/quartermaster/cargobay{
	name = "Cargo Primary Endpoint"
	})
"G" = (
/obj/machinery/computer/supplycomp,
/obj/cable{
	icon_state = "0-2"
	},
/obj/machinery/power/data_terminal,
/obj/decal/tile_edge/stripe/extra_big{
	dir = 4
	},
/turf/simulated/floor,
/area/station/quartermaster/cargobay{
	name = "Cargo Primary Endpoint"
	})
"H" = (
/obj/cable{
	icon_state = "4-8"
	},
/turf/simulated/floor/engine/caution/east,
/area/station/quartermaster/cargobay{
	name = "Cargo Primary Endpoint"
	})
"I" = (
/obj/machinery/light/small/floor,
/obj/cable{
	icon_state = "4-8"
	},
/turf/simulated/floor,
/area/station/quartermaster/cargobay{
	name = "Cargo Primary Endpoint"
	})
"J" = (
/obj/cable{
	icon_state = "4-8"
	},
/turf/simulated/floor/engine/caution/west,
/area/station/quartermaster/cargobay{
	name = "Cargo Primary Endpoint"
	})
"K" = (
/obj/machinery/door/airlock/pyro/engineering/alt,
/obj/mapping_helper/access/cargo,
/obj/cable{
	icon_state = "1-2"
	},
/obj/mapping_helper/firedoor_spawn,
/obj/disposalpipe/segment,
/turf/simulated/floor,
/area/station/quartermaster/cargobay{
	name = "Cargo Primary Endpoint"
	})
"L" = (
/obj/machinery/computer/transception,
/obj/machinery/light_switch/directional/north,
/obj/cable{
	icon_state = "0-2"
	},
/obj/machinery/power/data_terminal,
/turf/simulated/floor,
/area/station/quartermaster/cargobay{
	name = "Cargo Primary Endpoint"
	})
"M" = (
/obj/machinery/transception_pad,
/obj/cable{
	icon_state = "0-4"
	},
/obj/landmark/start/job/mail_courier,
/obj/machinery/power/data_terminal,
/turf/simulated/floor/engine/caution/misc{
	dir = 6
	},
/area/station/quartermaster/cargobay{
	name = "Cargo Primary Endpoint"
	})
"N" = (
/obj/cable{
	icon_state = "1-2"
	},
/obj/cable{
	icon_state = "1-4"
	},
/obj/cable{
	icon_state = "1-8"
	},
/obj/decal/tile_edge/stripe/extra_big{
	dir = 9;
	icon_state = "xtra_bigstripe-corner2"
	},
/turf/simulated/floor,
/area/station/quartermaster/cargobay{
	name = "Cargo Primary Endpoint"
	})
"O" = (
/obj/stool/chair/office/yellow,
/obj/landmark/start/job/quartermaster,
/obj/cable{
	icon_state = "4-8"
	},
/obj/cable{
	icon_state = "1-8"
	},
/turf/simulated/floor,
/area/station/quartermaster/cargobay{
	name = "Cargo Primary Endpoint"
	})
"P" = (
/obj/machinery/manufacturer/qm,
/obj/machinery/light/incandescent/netural,
/turf/simulated/floor,
/area/station/quartermaster/cargobay{
	name = "Cargo Primary Endpoint"
	})
"Q" = (
/obj/machinery/transception_pad,
/obj/cable{
	icon_state = "0-4"
	},
/obj/cable{
	icon_state = "0-8"
	},
/obj/machinery/power/data_terminal,
/turf/simulated/floor/engine/caution/misc{
	dir = 6
	},
/area/station/quartermaster/cargobay{
	name = "Cargo Primary Endpoint"
	})
"R" = (
/obj/table/reinforced/auto,
/obj/machinery/recharger,
/obj/item/cargotele,
/turf/simulated/floor,
/area/station/quartermaster/cargobay{
	name = "Cargo Primary Endpoint"
	})
"S" = (
/obj/machinery/disposal,
/obj/disposalpipe/trunk/north,
/turf/simulated/floor,
/area/station/quartermaster/cargobay{
	name = "Cargo Primary Endpoint"
	})
"U" = (
/obj/submachine/cargopad/qm,
/turf/simulated/floor/engine/caution,
/area/station/quartermaster/cargobay{
	name = "Cargo Primary Endpoint"
	})
"V" = (
/obj/cable{
	icon_state = "4-8"
	},
/turf/simulated/floor,
/area/station/quartermaster/cargobay{
	name = "Cargo Primary Endpoint"
	})
"W" = (
/obj/cable{
	icon_state = "1-2"
	},
/turf/simulated/floor,
/area/station/quartermaster/cargobay{
	name = "Cargo Primary Endpoint"
	})
"X" = (
/turf/simulated/floor/engine/caution/north,
/area/station/quartermaster/cargobay{
	name = "Cargo Primary Endpoint"
	})
"Y" = (
/obj/stool/chair/office/yellow{
	dir = 1
	},
/obj/landmark/start/job/quartermaster,
/obj/cable{
	icon_state = "4-8"
	},
/obj/disposalpipe/segment{
	dir = 4
	},
/turf/simulated/floor,
/area/station/quartermaster/cargobay{
	name = "Cargo Primary Endpoint"
	})
"Z" = (
/obj/landmark/start/job/quartermaster,
/obj/machinery/phone/wall{
	pixel_x = 24;
	pixel_y = 4
	},
/obj/cable{
	icon_state = "1-8"
	},
/turf/simulated/floor,
/area/station/quartermaster/cargobay{
	name = "Cargo Primary Endpoint"
	})

(1,1,1) = {"
E
E
E
E
f
E
E
E
E
"}
(2,1,1) = {"
E
n
g
i
J
c
c
q
E
"}
(3,1,1) = {"
E
G
z
X
Q
y
M
l
E
"}
(4,1,1) = {"
E
U
r
h
H
w
H
b
E
"}
(5,1,1) = {"
B
u
N
W
e
W
F
v
K
"}
(6,1,1) = {"
E
L
x
j
a
j
m
R
E
"}
(7,1,1) = {"
E
s
O
p
I
d
Y
P
E
"}
(8,1,1) = {"
E
o
Z
C
V
k
t
S
E
"}
(9,1,1) = {"
E
E
E
E
V
E
E
E
E
"}
