//MAP CONVERTED BY dmm2tgm.py THIS HEADER COMMENT PREVENTS RECONVERSION, DO NOT REMOVE
"a" = (
/turf/simulated/floor/carpet/clowncarpet,
/area/station/crew_quarters/clown)
"b" = (
/obj/cable{
	icon_state = "0-2"
	},
/obj/cable{
	icon_state = "2-4"
	},
/obj/cable{
	icon_state = "2-8"
	},
/obj/machinery/power/apc/autoname_north,
/turf/simulated/floor/carpet/purple/fancy/innercorner/omni,
/area/station/crew_quarters/clown)
"e" = (
/obj/table/neon/auto,
/obj/item/aiModule/hologram_expansion/clown{
	pixel_x = -1;
	pixel_y = 10
	},
/obj/item/peripheral/videocard{
	pixel_y = 5
	},
/obj/item/storage/goodybag{
	pixel_x = -3;
	pixel_y = -7
	},
/obj/machinery/light/incandescent/purpleish,
/turf/simulated/floor/carpet/clowncarpet/border{
	dir = 8
	},
/area/station/crew_quarters/clown)
"g" = (
/turf/simulated/wall/false_wall/reinforced{
	can_be_auto = 0;
	icon = 'icons/turf/walls/supernorn/reinforced/purple.dmi';
	icon_state = "norn-12"
	},
/area/station/crew_quarters/clown)
"h" = (
/obj/cable{
	icon_state = "1-8"
	},
/turf/simulated/wall/auto/reinforced/supernorn/colored,
/area/station/crew_quarters/clown)
"i" = (
/obj/cable{
	icon_state = "1-2"
	},
/obj/cable{
	icon_state = "2-8"
	},
/obj/cable{
	icon_state = "1-8"
	},
/turf/simulated/wall/auto/reinforced/supernorn/colored,
/area/station/crew_quarters/clown)
"j" = (
/obj/reagent_dispensers/heliumtank,
/turf/simulated/floor/carpet/clowncarpet/border{
	dir = 1
	},
/area/station/crew_quarters/clown)
"k" = (
/obj/stool/chair/comfy/sleek{
	dir = 1
	},
/obj/machinery/light/incandescent/purpleish,
/turf/simulated/floor/carpet/clowncarpet/border{
	dir = 4
	},
/area/station/crew_quarters/clown)
"l" = (
/obj/cable{
	icon_state = "4-8"
	},
/turf/simulated/wall/auto/reinforced/supernorn/colored,
/area/station/crew_quarters/clown)
"m" = (
/mob/living/critter/spider/clown,
/mob/living/critter/spider/clown,
/mob/living/critter/spider/clown,
/mob/living/critter/spider/clown,
/mob/living/critter/spider/clown,
/mob/living/critter/spider/clown,
/turf/simulated/floor/carpet/purple/fancy/narrow/west,
/area/station/crew_quarters/clown)
"o" = (
/obj/table/neon/auto,
/obj/item/instrument/bikehorn{
	pixel_x = -4;
	pixel_y = 9
	},
/obj/item/reagent_containers/food/snacks/pie/cream{
	pixel_x = 2
	},
/obj/item/storage/pill_bottle/cyberpunk{
	pixel_x = -7;
	pixel_y = -10
	},
/turf/simulated/floor/carpet/clowncarpet/border{
	dir = 9
	},
/area/station/crew_quarters/clown)
"q" = (
/obj/marker/supplymarker,
/turf/simulated/floor/carpet/clowncarpet/border,
/area/station/crew_quarters/clown)
"r" = (
/obj/stool/chair/syndicate{
	dir = 4
	},
/obj/npc/trader/exclown,
/turf/simulated/floor/carpet/clowncarpet/border{
	dir = 10
	},
/area/station/crew_quarters/clown)
"s" = (
/obj/cable{
	icon_state = "2-4"
	},
/turf/simulated/wall/auto/reinforced/supernorn/colored,
/area/station/crew_quarters/clown)
"t" = (
/turf/simulated/floor/carpet/clowncarpet/border,
/area/station/crew_quarters/clown)
"w" = (
/obj/table/neon/auto,
/obj/item/clothing/mask/clown_nose{
	pixel_y = 9;
	pixel_x = 6
	},
/obj/item/clothing/mask/cigarette/cigar/gold,
/obj/item/reagent_containers/food/drinks/bottle/beer{
	pixel_x = -6;
	pixel_y = 15
	},
/turf/simulated/floor/carpet/clowncarpet/border{
	dir = 1
	},
/area/station/crew_quarters/clown)
"A" = (
/obj/cable{
	icon_state = "1-4"
	},
/obj/cable{
	icon_state = "1-8"
	},
/obj/cable{
	icon_state = "4-8"
	},
/turf/simulated/wall/auto/reinforced/supernorn/colored,
/area/station/crew_quarters/clown)
"F" = (
/obj/item/reagent_containers/food/fish/clownfish,
/turf/simulated/floor/carpet/purple/fancy/narrow/west,
/area/station/crew_quarters/clown)
"H" = (
/obj/machinery/computer/announcement/clown,
/turf/simulated/floor/carpet/clowncarpet/border{
	dir = 5
	},
/area/station/crew_quarters/clown)
"I" = (
/mob/living/critter/spider/clown,
/mob/living/critter/spider/clown,
/mob/living/critter/spider/clown,
/mob/living/critter/spider/clown,
/mob/living/critter/spider/clown,
/mob/living/critter/spider/clown,
/turf/simulated/floor/carpet/purple/fancy/narrow/east,
/area/station/crew_quarters/clown)
"J" = (
/obj/cable{
	icon_state = "1-2"
	},
/obj/cable{
	icon_state = "2-4"
	},
/obj/cable{
	icon_state = "1-4"
	},
/turf/simulated/wall/auto/reinforced/supernorn/colored,
/area/station/crew_quarters/clown)
"K" = (
/obj/cable{
	icon_state = "1-4"
	},
/turf/simulated/wall/auto/reinforced/supernorn/colored,
/area/station/crew_quarters/clown)
"L" = (
/obj/machinery/light_switch/directional/east,
/obj/landmark/start/job/clown,
/obj/stool/bed,
/obj/item/clothing/suit/bedsheet/captain,
/turf/simulated/floor/carpet/clowncarpet/border{
	dir = 4
	},
/area/station/crew_quarters/clown)
"M" = (
/turf/simulated/wall/auto/reinforced/supernorn/colored,
/area/station/crew_quarters/clown)
"O" = (
/obj/cable{
	icon_state = "1-2"
	},
/turf/simulated/wall/auto/reinforced/supernorn/colored,
/area/station/crew_quarters/clown)
"P" = (
/obj/cable{
	icon_state = "2-8"
	},
/turf/simulated/wall/auto/reinforced/supernorn/colored,
/area/station/crew_quarters/clown)
"Q" = (
/obj/item/clothing/gloves/yellow{
	name = "pinksulated gloves";
	color = "#f57382";
	icon_state = "latex";
	item_state = "lgloves"
	},
/turf/simulated/floor/carpet/purple/fancy/narrow/east,
/area/station/crew_quarters/clown)
"R" = (
/obj/table/neon/auto,
/obj/machinery/phone/unlisted{
	name = "undetectable phone";
	stripe_color = "#f57382";
	phone_id = "The Clown"
	},
/turf/simulated/floor/carpet/clowncarpet/border{
	dir = 8
	},
/area/station/crew_quarters/clown)
"S" = (
/turf/simulated/wall/auto/reinforced/supernorn/colored/purple,
/area/station/crew_quarters/clown)
"U" = (
/obj/storage/crate/clown,
/turf/simulated/floor/carpet/clowncarpet/border{
	dir = 6
	},
/area/station/crew_quarters/clown)
"W" = (
/obj/machinery/light/incandescent/purpleish,
/turf/simulated/floor/carpet/clowncarpet/border,
/area/station/crew_quarters/clown)
"Y" = (
/obj/ladder{
	id = "clowntainment";
	icon_state = "ladder_wall";
	pixel_y = 20
	},
/obj/item/bananapeel,
/obj/machinery/light/incandescent/purpleish,
/turf/simulated/floor/carpet/clowncarpet/border{
	dir = 1
	},
/area/station/crew_quarters/clown)

(1,1,1) = {"
s
O
O
O
i
O
O
O
K
"}
(2,1,1) = {"
l
S
S
S
S
S
S
F
l
"}
(3,1,1) = {"
l
S
o
e
R
r
S
Q
l
"}
(4,1,1) = {"
l
S
j
a
a
q
S
M
l
"}
(5,1,1) = {"
A
S
Y
a
a
W
S
M
b
"}
(6,1,1) = {"
l
S
w
a
a
t
S
M
l
"}
(7,1,1) = {"
l
S
H
k
L
U
g
m
l
"}
(8,1,1) = {"
l
S
S
S
S
S
S
I
l
"}
(9,1,1) = {"
P
O
O
O
J
O
O
O
h
"}
