//MAP CONVERTED BY dmm2tgm.py THIS HEADER COMMENT PREVENTS RECONVERSION, DO NOT REMOVE
"a" = (
/turf/simulated/wall/auto/reinforced/supernorn/colored/yellow,
/area/station/engine/gas)
"b" = (
/obj/machinery/portable_atmospherics/canister/carbon_dioxide,
/turf/simulated/floor/black/grime,
/area/station/engine/gas)
"c" = (
/obj/mapping_helper/wingrille_spawn/auto,
/obj/window_blinds/cog2/right{
	dir = 4
	},
/turf/simulated/floor/plating,
/area/station/janitor/office)
"d" = (
/obj/storage/closet/janitor,
/turf/simulated/floor/specialroom/arcade,
/area/station/janitor/office)
"e" = (
/obj/cable{
	icon_state = "1-2"
	},
/obj/blind_switch/directional/west{
	pixel_y = 6
	},
/obj/machinery/light_switch/directional/west{
	pixel_y = -5
	},
/turf/simulated/floor/darkblue,
/area/station/janitor/office)
"f" = (
/obj/cable{
	icon_state = "1-2"
	},
/turf/simulated/floor/black/grime,
/area/station/engine/gas)
"g" = (
/obj/mapping_helper/firedoor_spawn,
/obj/cable{
	icon_state = "4-8"
	},
/obj/machinery/door/airlock/pyro/engineering/alt{
	dir = 4
	},
/obj/mapping_helper/access/engineering_atmos,
/turf/simulated/floor/black/grime,
/area/station/engine/gas)
"h" = (
/obj/cable{
	icon_state = "1-4"
	},
/obj/machinery/light/small/floor,
/obj/landmark/gps_waypoint,
/turf/simulated/floor/black/grime,
/area/station/engine/gas)
"i" = (
/obj/machinery/vending/janitor,
/turf/simulated/floor/specialroom/arcade,
/area/station/janitor/office)
"j" = (
/obj/machinery/portable_atmospherics/canister/toxins,
/obj/machinery/light{
	dir = 1;
	layer = 9.1;
	pixel_y = 21
	},
/turf/simulated/floor/black/grime,
/area/station/engine/gas)
"k" = (
/obj/machinery/portable_atmospherics/canister/oxygen,
/turf/simulated/floor/black/grime,
/area/station/engine/gas)
"l" = (
/obj/machinery/portable_atmospherics/canister/nitrogen,
/obj/machinery/alarm/directional/west,
/turf/simulated/floor/black/grime,
/area/station/engine/gas)
"m" = (
/obj/disposalpipe/segment/vertical,
/turf/simulated/wall/auto/supernorn/colored/purple,
/area/station/janitor/office)
"n" = (
/obj/machinery/atmospherics/pipe/simple{
	dir = 9
	},
/obj/cable{
	icon_state = "4-8"
	},
/obj/disposalpipe/segment/bent/south,
/obj/vehicle/floorbuffer{
	dir = 4
	},
/obj/machinery/light/incandescent/netural,
/turf/simulated/floor/darkblue,
/area/station/janitor/office)
"o" = (
/obj/cable{
	icon_state = "4-8"
	},
/turf/simulated/floor/black/grime,
/area/station/engine/gas)
"q" = (
/obj/machinery/light/small/floor,
/obj/stool/chair{
	dir = 1
	},
/obj/landmark/start/job/janitor,
/turf/simulated/floor/specialroom/arcade,
/area/station/janitor/office)
"r" = (
/obj/machinery/manufacturer/gas,
/turf/simulated/floor/black/grime,
/area/station/engine/gas)
"s" = (
/obj/storage/closet/biohazard,
/turf/simulated/floor/specialroom/arcade,
/area/station/janitor/office)
"u" = (
/obj/mapping_helper/wingrille_spawn/auto,
/obj/window_blinds/cog2/left{
	dir = 4
	},
/turf/simulated/floor/plating,
/area/station/janitor/office)
"v" = (
/obj/machinery/computer3/generic/personal,
/obj/table/auto,
/turf/simulated/floor/specialroom/arcade,
/area/station/janitor/office)
"w" = (
/obj/machinery/portable_atmospherics/canister/oxygen,
/obj/machinery/portable_atmospherics/canister/oxygen,
/turf/simulated/floor/black/grime,
/area/station/engine/gas)
"x" = (
/obj/mapping_helper/wingrille_spawn/auto,
/obj/window_blinds/cog2/left,
/turf/simulated/floor/plating,
/area/station/janitor/office)
"y" = (
/obj/machinery/portable_atmospherics/canister/oxygen,
/obj/machinery/light{
	dir = 4;
	layer = 9.1;
	pixel_x = 10
	},
/turf/simulated/floor/black/grime,
/area/station/engine/gas)
"z" = (
/obj/machinery/drainage,
/turf/simulated/floor/specialroom/arcade,
/area/station/janitor/office)
"A" = (
/obj/machinery/atmospherics/pipe/simple{
	dir = 4
	},
/turf/simulated/wall/auto/supernorn/colored/purple,
/area/station/janitor/office)
"B" = (
/obj/machinery/camera/directional/south,
/turf/simulated/floor/black/grime,
/area/station/engine/gas)
"C" = (
/obj/machinery/portable_atmospherics/canister/toxins,
/turf/simulated/floor/black/grime,
/area/station/engine/gas)
"D" = (
/obj/storage/secure/closet/civilian/janitor,
/turf/simulated/floor/specialroom/arcade,
/area/station/janitor/office)
"E" = (
/obj/mapping_helper/firedoor_spawn,
/obj/cable{
	icon_state = "1-2"
	},
/obj/machinery/door/airlock/pyro/engineering/alt,
/obj/disposalpipe/segment/vertical,
/obj/mapping_helper/access/engineering_atmos,
/turf/simulated/floor/black/grime,
/area/station/engine/gas)
"F" = (
/turf/simulated/wall/auto/supernorn/colored/purple,
/area/station/janitor/office)
"G" = (
/obj/machinery/power/apc/autoname_west,
/obj/cable,
/obj/cable{
	icon_state = "1-2"
	},
/obj/mopbucket,
/turf/simulated/floor/darkblue,
/area/station/janitor/office)
"H" = (
/obj/machinery/atmospherics/unary/outlet_injector/active,
/turf/simulated/floor/specialroom/arcade,
/area/station/janitor/office)
"I" = (
/obj/cable{
	icon_state = "1-2"
	},
/obj/disposalpipe/segment/vertical,
/turf/simulated/floor/black/grime,
/area/station/engine/gas)
"J" = (
/obj/machinery/light_switch/directional/west,
/turf/simulated/floor/black/grime,
/area/station/engine/gas)
"K" = (
/obj/machinery/atmospherics/pipe/simple{
	dir = 4
	},
/obj/cable{
	icon_state = "1-2"
	},
/obj/cable{
	icon_state = "1-4"
	},
/obj/machinery/disposal/cart_port,
/obj/disposalpipe/trunk/east,
/obj/storage/cart/trash,
/turf/simulated/floor/darkblue,
/area/station/janitor/office)
"L" = (
/obj/cable{
	icon_state = "4-8"
	},
/obj/machinery/door/airlock/pyro{
	dir = 4
	},
/obj/mapping_helper/access/janitor,
/obj/mapping_helper/firedoor_spawn,
/turf/simulated/floor/darkblue,
/area/station/janitor/office)
"M" = (
/obj/machinery/atmospherics/unary/portables_connector{
	dir = 4;
	name = "Barbershop Repressurization"
	},
/obj/cable{
	icon_state = "2-8"
	},
/turf/simulated/floor/black/grime,
/area/station/engine/gas)
"N" = (
/obj/cable{
	icon_state = "4-8"
	},
/turf/simulated/floor/darkblue,
/area/station/janitor/office)
"O" = (
/obj/machinery/firealarm/directional/north,
/obj/cable{
	icon_state = "1-2"
	},
/obj/cable{
	icon_state = "2-4"
	},
/obj/cable{
	icon_state = "2-8"
	},
/obj/disposalpipe/segment/bent/east,
/turf/simulated/floor/black/grime,
/area/station/engine/gas)
"P" = (
/obj/machinery/portable_atmospherics/canister/nitrogen,
/turf/simulated/floor/black/grime,
/area/station/engine/gas)
"Q" = (
/obj/machinery/portable_atmospherics/canister/toxins,
/obj/decal/poster/wallsign/iso/warning/biological,
/obj/item/wrench/yellow{
	pixel_x = -5;
	pixel_y = 3
	},
/turf/simulated/floor/black/grime,
/area/station/engine/gas)
"R" = (
/obj/cable{
	icon_state = "1-2"
	},
/turf/simulated/wall/auto/supernorn/colored/purple,
/area/station/janitor/office)
"S" = (
/obj/mapping_helper/wingrille_spawn/auto,
/obj/window_blinds/cog2/right,
/turf/simulated/floor/plating,
/area/station/janitor/office)
"T" = (
/obj/landmark/gps_waypoint,
/turf/simulated/floor/specialroom/arcade,
/area/station/janitor/office)
"U" = (
/obj/cable{
	icon_state = "1-2"
	},
/obj/machinery/door/airlock/pyro,
/obj/mapping_helper/access/janitor,
/obj/mapping_helper/firedoor_spawn,
/turf/simulated/floor/darkblue,
/area/station/janitor/office)
"V" = (
/obj/machinery/power/apc/autoname_north,
/obj/cable{
	icon_state = "0-8"
	},
/obj/disposalpipe/segment/bent/west,
/turf/simulated/floor/black/grime,
/area/station/engine/gas)
"W" = (
/obj/tug_cart,
/turf/simulated/floor/black/grime,
/area/station/engine/gas)
"X" = (
/obj/machinery/portable_atmospherics/canister/toxins,
/obj/machinery/camera/directional/west,
/turf/simulated/floor/black/grime,
/area/station/engine/gas)
"Y" = (
/obj/machinery/sink/slim{
	dir = 4;
	pixel_x = -9
	},
/obj/cable{
	icon_state = "1-2"
	},
/obj/landmark/start/job/janitor,
/turf/simulated/floor/darkblue,
/area/station/janitor/office)
"Z" = (
/obj/machinery/portable_atmospherics/canister/oxygen,
/obj/decal/poster/wallsign/iso/prohibited/fire,
/turf/simulated/floor/black/grime,
/area/station/engine/gas)

(1,1,1) = {"
a
a
a
a
g
a
a
a
a
"}
(2,1,1) = {"
a
j
X
J
o
P
l
b
a
"}
(3,1,1) = {"
a
Q
C
r
M
f
h
b
a
"}
(4,1,1) = {"
F
F
F
F
A
F
o
W
a
"}
(5,1,1) = {"
U
e
Y
G
K
R
O
I
E
"}
(6,1,1) = {"
F
i
T
H
n
m
V
B
a
"}
(7,1,1) = {"
x
v
q
z
N
F
Z
w
a
"}
(8,1,1) = {"
S
D
d
s
N
F
y
k
a
"}
(9,1,1) = {"
F
c
u
F
L
F
a
a
a
"}
