//MAP CONVERTED BY dmm2tgm.py THIS HEADER COMMENT PREVENTS RECONVERSION, DO NOT REMOVE
"a" = (
/obj/machinery/the_singularitygen,
/turf/simulated/floor/engine/glow/blue,
/area/station/engine/core/singularity)
"b" = (
/obj/cable/orange{
	icon_state = "2-8"
	},
/obj/machinery/light{
	dir = 1;
	layer = 9.1;
	pixel_y = 21
	},
/turf/simulated/floor/engine/caution/corner{
	dir = 4
	},
/area/station/engine/core/singularity)
"c" = (
/obj/machinery/power/collector_control,
/obj/cable/orange{
	icon_state = "0-2"
	},
/obj/cable/orange,
/obj/machinery/power/data_terminal,
/turf/simulated/floor/engine/caution/westeast,
/area/station/engine/core/singularity)
"d" = (
/turf/simulated/floor/engine/glow/blue,
/area/station/engine/core/singularity)
"e" = (
/obj/cable{
	icon_state = "1-2"
	},
/obj/machinery/light{
	dir = 4;
	layer = 9.1;
	pixel_x = 10
	},
/turf/simulated/floor/yellowblack{
	dir = 4
	},
/area/station/engine/core/singularity)
"f" = (
/obj/cable{
	icon_state = "1-4"
	},
/obj/machinery/camera/directional/west,
/turf/simulated/floor/yellowblack{
	dir = 10
	},
/area/station/engine/core/singularity)
"g" = (
/obj/disposalpipe/segment/vertical,
/obj/cable{
	icon_state = "2-4"
	},
/obj/cable{
	icon_state = "2-8"
	},
/obj/cable{
	icon_state = "4-8"
	},
/obj/machinery/door/airlock/pyro/engineering,
/obj/mapping_helper/firedoor_spawn,
/obj/mapping_helper/access/engineering_engine,
/turf/simulated/floor/black,
/area/station/engine/core/singularity)
"h" = (
/obj/machinery/power/terminal{
	dir = 8
	},
/obj/cable/orange,
/obj/machinery/computer/power_monitor/smes{
	dir = 4
	},
/turf/simulated/floor/black,
/area/station/engine/core/singularity)
"i" = (
/obj/cable{
	icon_state = "1-2"
	},
/turf/simulated/floor/yellowblack{
	dir = 8
	},
/area/station/engine/core/singularity)
"j" = (
/obj/cable{
	icon_state = "1-8"
	},
/obj/cable{
	icon_state = "2-8"
	},
/turf/simulated/floor/black,
/area/station/engine/core/singularity)
"l" = (
/obj/cable{
	icon_state = "1-2"
	},
/obj/machinery/light{
	dir = 8;
	layer = 9.1;
	pixel_x = -10
	},
/turf/simulated/floor/yellowblack{
	dir = 8
	},
/area/station/engine/core/singularity)
"m" = (
/obj/machinery/emitter,
/obj/machinery/power/data_terminal,
/obj/cable/orange{
	icon_state = "0-4"
	},
/turf/simulated/floor/engine/caution/northsouth,
/area/station/engine/core/singularity)
"n" = (
/obj/cable{
	icon_state = "2-8"
	},
/turf/simulated/wall/auto/reinforced/supernorn/colored/yellow/plasmasteel,
/area/station/engine/core/singularity)
"o" = (
/obj/cable{
	icon_state = "1-2"
	},
/turf/simulated/floor/black,
/area/station/engine/core/singularity)
"p" = (
/obj/cable/orange{
	icon_state = "1-2"
	},
/turf/simulated/floor/black,
/area/station/engine/core/singularity)
"q" = (
/obj/cable{
	icon_state = "2-4"
	},
/turf/simulated/wall/auto/reinforced/supernorn/colored/yellow/plasmasteel,
/area/station/engine/core/singularity)
"r" = (
/obj/cable{
	icon_state = "2-8"
	},
/turf/simulated/floor/black,
/area/station/engine/core/singularity)
"s" = (
/obj/machinery/power/smes,
/turf/simulated/floor/yellowblack{
	dir = 6
	},
/area/station/engine/core/singularity)
"u" = (
/obj/cable/orange{
	icon_state = "1-4"
	},
/obj/storage/closet/radiation,
/obj/item/clothing/shoes/magnetic{
	pixel_x = -7;
	pixel_y = -4
	},
/obj/item/clothing/shoes/magnetic{
	pixel_x = 6;
	pixel_y = -4
	},
/turf/simulated/floor/engine/caution/corner,
/area/station/engine/core/singularity)
"v" = (
/obj/machinery/field_generator,
/turf/simulated/floor/engine/glow/blue,
/area/station/engine/core/singularity)
"w" = (
/obj/cable{
	icon_state = "4-8"
	},
/turf/simulated/wall/auto/reinforced/supernorn/colored/yellow/plasmasteel,
/area/station/engine/core/singularity)
"x" = (
/turf/simulated/floor/black,
/area/station/engine/core/singularity)
"y" = (
/obj/machinery/dispenser,
/obj/machinery/light{
	dir = 8;
	layer = 9.1;
	pixel_x = -10
	},
/turf/simulated/floor/yellow,
/area/station/engine/core/singularity)
"z" = (
/obj/cable{
	icon_state = "1-8"
	},
/obj/cable{
	icon_state = "1-4"
	},
/turf/simulated/wall/auto/reinforced/supernorn/colored/yellow/plasmasteel,
/area/station/engine/core/singularity)
"A" = (
/obj/machinery/power/collector_array,
/obj/cable/orange,
/obj/cable/orange{
	icon_state = "0-2"
	},
/obj/machinery/power/data_terminal,
/turf/simulated/floor/engine/caution/westeast,
/area/station/engine/core/singularity)
"B" = (
/obj/machinery/emitter,
/obj/machinery/power/data_terminal,
/obj/cable/orange{
	icon_state = "0-8"
	},
/turf/simulated/floor/engine/caution/northsouth,
/area/station/engine/core/singularity)
"C" = (
/obj/cable{
	icon_state = "2-4"
	},
/turf/simulated/floor/black,
/area/station/engine/core/singularity)
"D" = (
/obj/cable{
	dir = null
	},
/obj/cable{
	icon_state = "0-2"
	},
/obj/machinery/firealarm/directional/east,
/obj/decal/poster/wallsign/iso/warning/laser,
/turf/simulated/floor/yellowblack{
	dir = 5
	},
/area/station/engine/core/singularity)
"E" = (
/obj/cable/orange{
	icon_state = "1-8"
	},
/obj/storage/closet/radiation,
/obj/item/clothing/shoes/magnetic{
	pixel_x = 6;
	pixel_y = -4
	},
/obj/item/clothing/shoes/magnetic{
	pixel_x = -7;
	pixel_y = -4
	},
/turf/simulated/floor/engine/caution/corner{
	dir = 1
	},
/area/station/engine/core/singularity)
"F" = (
/obj/machinery/emitter{
	dir = 1
	},
/obj/machinery/power/data_terminal,
/obj/cable/orange{
	icon_state = "0-2"
	},
/obj/cable/orange{
	icon_state = "0-4"
	},
/obj/cable/orange{
	icon_state = "0-8"
	},
/turf/simulated/floor/engine/caution/northsouth,
/area/station/engine/core/singularity)
"G" = (
/obj/machinery/power/collector_control,
/obj/cable/orange,
/obj/cable/orange{
	icon_state = "0-2"
	},
/obj/machinery/power/data_terminal,
/turf/simulated/floor/engine/caution/westeast,
/area/station/engine/core/singularity)
"H" = (
/obj/machinery/light{
	dir = 4;
	layer = 9.1;
	pixel_x = 10
	},
/obj/storage/closet/welding_supply,
/obj/item/clothing/shoes/magnetic{
	pixel_x = -7;
	pixel_y = -4
	},
/obj/item/clothing/shoes/magnetic{
	pixel_x = 6;
	pixel_y = -4
	},
/turf/simulated/floor/yellow,
/area/station/engine/core/singularity)
"I" = (
/obj/cable{
	icon_state = "1-8"
	},
/turf/simulated/wall/auto/reinforced/supernorn/colored/yellow/plasmasteel,
/area/station/engine/core/singularity)
"J" = (
/obj/decal/poster/wallsign/iso/mandatory/welding,
/obj/item/wrench/yellow{
	pixel_x = -5;
	pixel_y = 3
	},
/obj/item/crowbar/yellow{
	pixel_x = 4;
	pixel_y = -6
	},
/turf/simulated/floor/engine/caution/northsouth,
/area/station/engine/core/singularity)
"K" = (
/obj/machinery/power/collector_array,
/obj/cable/orange{
	icon_state = "0-2"
	},
/obj/cable/orange,
/obj/machinery/power/data_terminal,
/turf/simulated/floor/engine/caution/westeast,
/area/station/engine/core/singularity)
"L" = (
/turf/simulated/wall/auto/reinforced/supernorn/colored/yellow/plasmasteel,
/area/station/engine/core/singularity)
"M" = (
/obj/cable{
	icon_state = "4-8"
	},
/obj/machinery/door/airlock/pyro/engineering{
	dir = 4
	},
/obj/mapping_helper/firedoor_spawn,
/obj/mapping_helper/access/engineering_engine,
/turf/simulated/floor/black,
/area/station/engine/core/singularity)
"N" = (
/obj/cable{
	icon_state = "1-4"
	},
/turf/simulated/wall/auto/reinforced/supernorn/colored/yellow/plasmasteel,
/area/station/engine/core/singularity)
"O" = (
/obj/landmark/start/job/engineer,
/obj/stool/chair/yellow{
	dir = 8
	},
/turf/simulated/floor/black,
/area/station/engine/core/singularity)
"P" = (
/obj/cable{
	dir = null
	},
/obj/cable{
	icon_state = "0-2"
	},
/obj/machinery/power/apc/autoname_west,
/obj/decal/poster/wallsign/iso/warning/radiation,
/turf/simulated/floor/yellowblack{
	dir = 9
	},
/area/station/engine/core/singularity)
"Q" = (
/obj/cable{
	icon_state = "2-4"
	},
/obj/cable{
	icon_state = "1-4"
	},
/turf/simulated/floor/black,
/area/station/engine/core/singularity)
"R" = (
/obj/cable/orange{
	icon_state = "2-4"
	},
/obj/machinery/light{
	dir = 1;
	layer = 9.1;
	pixel_y = 21
	},
/turf/simulated/floor/engine/caution/corner{
	dir = 8
	},
/area/station/engine/core/singularity)
"S" = (
/obj/machinery/power/terminal{
	dir = 4
	},
/obj/cable/orange,
/obj/machinery/computer3/generic/engine{
	dir = 8
	},
/turf/simulated/floor/black,
/area/station/engine/core/singularity)
"U" = (
/obj/machinery/power/collector_array,
/obj/cable/orange{
	icon_state = "0-2"
	},
/obj/machinery/power/data_terminal,
/obj/cable/orange,
/turf/simulated/floor/engine/caution/westeast,
/area/station/engine/core/singularity)
"V" = (
/obj/cable/orange{
	icon_state = "4-8"
	},
/turf/simulated/floor/engine/caution/northsouth,
/area/station/engine/core/singularity)
"W" = (
/obj/cable{
	icon_state = "1-2"
	},
/obj/machinery/camera/directional/east,
/turf/simulated/floor/yellowblack{
	dir = 4
	},
/area/station/engine/core/singularity)
"Y" = (
/obj/machinery/power/smes,
/turf/simulated/floor/yellowblack{
	dir = 10
	},
/area/station/engine/core/singularity)
"Z" = (
/obj/cable{
	icon_state = "1-8"
	},
/obj/machinery/alarm/directional/east,
/turf/simulated/floor/yellowblack{
	dir = 6
	},
/area/station/engine/core/singularity)

(1,1,1) = {"
L
L
L
L
M
L
L
L
L
"}
(2,1,1) = {"
q
P
i
l
j
i
f
y
L
"}
(3,1,1) = {"
w
R
U
c
K
u
r
Y
N
"}
(4,1,1) = {"
w
B
v
d
v
F
p
h
w
"}
(5,1,1) = {"
z
J
d
a
d
V
x
O
g
"}
(6,1,1) = {"
w
m
v
d
v
F
p
S
w
"}
(7,1,1) = {"
w
b
U
G
A
E
C
s
I
"}
(8,1,1) = {"
n
D
W
e
Q
o
Z
H
L
"}
(9,1,1) = {"
L
L
L
L
M
L
L
L
L
"}
