//MAP CONVERTED BY dmm2tgm.py THIS HEADER COMMENT PREVENTS RECONVERSION, DO NOT REMOVE
"a" = (
/obj/machinery/firealarm/directional/west,
/obj/disposalpipe/segment/vertical,
/turf/simulated/floor/carpet/red/fancy/edge/sw,
/area/station/crew_quarters/info{
	name = "Net Cafe"
	})
"b" = (
/obj/cable{
	icon_state = "4-8"
	},
/obj/disposalpipe/segment/vertical,
/turf/simulated/floor/carpet/red/fancy/edge/west,
/area/station/crew_quarters/info{
	name = "Net Cafe"
	})
"d" = (
/obj/mapping_helper/wingrille_spawn/auto/reinforced,
/obj/cable,
/turf/simulated/floor/plating,
/area/station/crew_quarters/market)
"e" = (
/obj/table/glass/auto,
/obj/item/paper_bin{
	pixel_y = 6
	},
/obj/random_item_spawner/desk_stuff,
/obj/machinery/light/incandescent/cool,
/turf/simulated/floor/redblack{
	dir = 10
	},
/area/station/crew_quarters/info{
	name = "Net Cafe"
	})
"f" = (
/obj/machinery/door/airlock/pyro/glass,
/obj/cable{
	icon_state = "1-2"
	},
/obj/mapping_helper/firedoor_spawn,
/obj/disposalpipe/segment/vertical,
/turf/simulated/floor,
/area/station/crew_quarters/info{
	name = "Net Cafe"
	})
"g" = (
/obj/cable{
	icon_state = "4-8"
	},
/turf/simulated/floor/carpet/red/fancy/edge/east,
/area/station/crew_quarters/info{
	name = "Net Cafe"
	})
"h" = (
/obj/table/reinforced/auto,
/obj/machinery/door/airlock/pyro/glass/windoor{
	autoclose = 0;
	dir = 8;
	id = "marketstall2"
	},
/obj/mapping_helper/firedoor_spawn,
/obj/machinery/cashreg,
/turf/simulated/floor,
/area/station/crew_quarters/market)
"i" = (
/obj/cable{
	icon_state = "4-8"
	},
/obj/cable{
	icon_state = "2-4"
	},
/obj/cable{
	icon_state = "1-4"
	},
/turf/simulated/floor,
/area/station/crew_quarters/market)
"j" = (
/obj/machinery/light/incandescent/cool,
/obj/storage/closet,
/turf/simulated/floor,
/area/station/crew_quarters/market)
"k" = (
/obj/machinery/power/apc/autoname_east,
/obj/machinery/photocopier,
/obj/cable{
	icon_state = "0-8"
	},
/turf/simulated/floor/carpet/red/fancy/edge/ne,
/area/station/crew_quarters/info{
	name = "Net Cafe"
	})
"l" = (
/obj/cable{
	icon_state = "2-4"
	},
/obj/disposalpipe/segment/vertical,
/turf/simulated/floor/redblack,
/area/station/crew_quarters/info{
	name = "Net Cafe"
	})
"m" = (
/turf/simulated/floor,
/area/station/crew_quarters/market)
"n" = (
/obj/cable{
	icon_state = "1-8"
	},
/obj/disposalpipe/segment/bent/west,
/turf/simulated/floor/red/redblackchecker,
/area/station/crew_quarters/info{
	name = "Net Cafe"
	})
"o" = (
/obj/machinery/computer/stockexchange,
/obj/machinery/light/incandescent/cool,
/turf/simulated/floor/circuit/red,
/area/station/crew_quarters/info{
	name = "Net Cafe"
	})
"p" = (
/obj/stool/chair,
/obj/machinery/camera/directional/east,
/turf/simulated/floor/redblack,
/area/station/crew_quarters/info{
	name = "Net Cafe"
	})
"q" = (
/obj/table/reinforced/auto,
/obj/machinery/door/airlock/pyro/glass/windoor{
	autoclose = 0;
	dir = 8;
	id = "marketstall1"
	},
/obj/mapping_helper/firedoor_spawn,
/obj/machinery/cashreg,
/turf/simulated/floor,
/area/station/crew_quarters/market)
"r" = (
/obj/machinery/door/airlock/pyro/glass{
	id = "marketstallmain2"
	},
/obj/mapping_helper/firedoor_spawn,
/turf/simulated/floor,
/area/station/crew_quarters/market)
"s" = (
/obj/mapping_helper/wingrille_spawn/auto,
/turf/simulated/floor/plating,
/area/station/crew_quarters/info{
	name = "Net Cafe"
	})
"t" = (
/obj/table/reinforced/auto,
/obj/machinery/door/airlock/pyro/glass/windoor{
	autoclose = 0;
	id = "marketstall1"
	},
/obj/mapping_helper/firedoor_spawn,
/turf/simulated/floor,
/area/station/crew_quarters/market)
"u" = (
/obj/machinery/computer3/terminal/zeta,
/obj/machinery/power/data_terminal,
/obj/cable,
/turf/simulated/floor/circuit/red,
/area/station/crew_quarters/info{
	name = "Net Cafe"
	})
"v" = (
/obj/cable{
	icon_state = "1-2"
	},
/turf/simulated/wall/auto/supernorn/colored,
/area/station/crew_quarters/info{
	name = "Net Cafe"
	})
"w" = (
/obj/table/glass/auto,
/obj/machinery/computer3/generic/personal,
/obj/machinery/power/data_terminal,
/obj/cable{
	icon_state = "0-2"
	},
/obj/machinery/light/incandescent/cool,
/turf/simulated/floor/circuit/red,
/area/station/crew_quarters/info{
	name = "Net Cafe"
	})
"x" = (
/obj/mapping_helper/wingrille_spawn/auto/reinforced,
/obj/cable{
	icon_state = "0-2"
	},
/turf/simulated/floor/plating,
/area/station/crew_quarters/market)
"y" = (
/obj/machinery/door/airlock/pyro/glass{
	dir = 4
	},
/obj/cable{
	icon_state = "4-8"
	},
/obj/mapping_helper/firedoor_spawn,
/turf/simulated/floor,
/area/station/crew_quarters/info{
	name = "Net Cafe"
	})
"z" = (
/obj/stool/chair,
/obj/cable{
	icon_state = "1-8"
	},
/obj/cable{
	icon_state = "1-2"
	},
/turf/simulated/floor/redblack,
/area/station/crew_quarters/info{
	name = "Net Cafe"
	})
"A" = (
/obj/table/reinforced/auto,
/obj/machinery/door/airlock/pyro/glass/windoor{
	autoclose = 0;
	dir = 1;
	id = "marketstall2"
	},
/obj/mapping_helper/firedoor_spawn,
/turf/simulated/floor,
/area/station/crew_quarters/market)
"B" = (
/obj/machinery/firealarm/directional/east,
/turf/simulated/floor,
/area/station/crew_quarters/market)
"C" = (
/obj/table/glass/auto,
/obj/machinery/computer3/generic/personal,
/obj/machinery/power/data_terminal,
/obj/cable{
	icon_state = "0-2"
	},
/turf/simulated/floor/circuit/red,
/area/station/crew_quarters/info{
	name = "Net Cafe"
	})
"D" = (
/obj/cable{
	icon_state = "1-4"
	},
/obj/cable{
	icon_state = "4-8"
	},
/turf/simulated/floor/redblack{
	dir = 1
	},
/area/station/crew_quarters/info{
	name = "Net Cafe"
	})
"E" = (
/obj/machinery/disposal/small/east,
/obj/disposalpipe/trunk/south,
/turf/simulated/floor/carpet/red/fancy/edge/nw,
/area/station/crew_quarters/info{
	name = "Net Cafe"
	})
"F" = (
/obj/stool/chair{
	dir = 1
	},
/obj/cable{
	icon_state = "2-4"
	},
/obj/cable{
	icon_state = "2-8"
	},
/obj/cable{
	icon_state = "1-2"
	},
/turf/simulated/floor/redblack{
	dir = 1
	},
/area/station/crew_quarters/info{
	name = "Net Cafe"
	})
"G" = (
/obj/cable{
	icon_state = "1-2"
	},
/obj/cable{
	icon_state = "2-4"
	},
/turf/simulated/floor/carpet/red/fancy/edge/north,
/area/station/crew_quarters/info{
	name = "Net Cafe"
	})
"H" = (
/obj/table/reinforced/auto,
/obj/machinery/door/airlock/pyro/glass/windoor{
	autoclose = 0;
	dir = 8;
	id = "marketstall1"
	},
/obj/mapping_helper/firedoor_spawn,
/turf/simulated/floor,
/area/station/crew_quarters/market)
"I" = (
/turf/simulated/wall/auto/supernorn/colored,
/area/station/crew_quarters/market)
"J" = (
/obj/cable{
	icon_state = "1-2"
	},
/turf/simulated/floor/carpet/red/fancy/edge/south,
/area/station/crew_quarters/info{
	name = "Net Cafe"
	})
"K" = (
/obj/machinery/power/apc/autoname_south,
/obj/machinery/camera/directional/north,
/obj/cable{
	icon_state = "0-4"
	},
/obj/cable{
	icon_state = "0-8"
	},
/turf/simulated/floor,
/area/station/crew_quarters/market)
"L" = (
/obj/machinery/door_control/bolter/new_walls/east{
	id = "marketstallmain1";
	pixel_y = 8
	},
/obj/machinery/door_control/bolter/new_walls/east{
	pixel_y = -8;
	id = "marketstall1"
	},
/turf/simulated/floor,
/area/station/crew_quarters/market)
"M" = (
/obj/cable{
	icon_state = "2-8"
	},
/turf/simulated/floor/red/redblackchecker,
/area/station/crew_quarters/info{
	name = "Net Cafe"
	})
"N" = (
/turf/simulated/wall/auto/supernorn/colored,
/area/station/crew_quarters/info{
	name = "Net Cafe"
	})
"O" = (
/obj/cable{
	icon_state = "4-8"
	},
/obj/cable{
	icon_state = "2-4"
	},
/obj/cable{
	icon_state = "1-4"
	},
/obj/landmark/gps_waypoint,
/turf/simulated/floor/carpet/red,
/area/station/crew_quarters/info{
	name = "Net Cafe"
	})
"P" = (
/obj/machinery/vending/coffee,
/obj/machinery/light/incandescent/cool,
/turf/simulated/floor/carpet/red/fancy/edge/se,
/area/station/crew_quarters/info{
	name = "Net Cafe"
	})
"Q" = (
/obj/machinery/door/airlock/pyro/glass{
	id = "marketstallmain1"
	},
/obj/mapping_helper/firedoor_spawn,
/turf/simulated/floor,
/area/station/crew_quarters/market)
"R" = (
/obj/table/reinforced/auto,
/obj/machinery/door/airlock/pyro/glass/windoor{
	autoclose = 0;
	dir = 8;
	id = "marketstall2"
	},
/obj/mapping_helper/firedoor_spawn,
/turf/simulated/floor,
/area/station/crew_quarters/market)
"S" = (
/obj/table/glass/auto,
/obj/machinery/networked/printer{
	name = "Printer - NetCafe";
	pixel_y = 5;
	print_id = "NetCafe"
	},
/obj/machinery/power/data_terminal,
/obj/cable{
	icon_state = "0-4"
	},
/obj/cable{
	icon_state = "1-4"
	},
/turf/simulated/floor/circuit/red,
/area/station/crew_quarters/info{
	name = "Net Cafe"
	})
"T" = (
/obj/cable{
	icon_state = "4-8"
	},
/obj/landmark/gps_waypoint,
/turf/simulated/floor,
/area/station/crew_quarters/market)
"U" = (
/obj/cable{
	icon_state = "2-4"
	},
/obj/disposalpipe/segment/bent/east,
/turf/simulated/floor/red/redblackchecker,
/area/station/crew_quarters/info{
	name = "Net Cafe"
	})
"V" = (
/obj/table/glass/auto,
/obj/machinery/networked/storage/scanner{
	bank_id = "netcafe";
	pixel_y = 4
	},
/obj/machinery/power/data_terminal,
/obj/cable{
	icon_state = "0-4"
	},
/obj/machinery/light/incandescent/cool,
/turf/simulated/floor/circuit/red,
/area/station/crew_quarters/info{
	name = "Net Cafe"
	})
"W" = (
/obj/machinery/door_control/bolter/new_walls/east{
	id = "marketstallmain2";
	pixel_y = -8
	},
/obj/machinery/door_control/bolter/new_walls/east{
	pixel_y = 8;
	id = "marketstall2"
	},
/turf/simulated/floor,
/area/station/crew_quarters/market)
"X" = (
/obj/machinery/door/airlock/pyro/glass{
	dir = 4
	},
/obj/cable{
	icon_state = "4-8"
	},
/obj/mapping_helper/firedoor_spawn,
/turf/simulated/floor/red/redblackchecker,
/area/station/crew_quarters/info{
	name = "Net Cafe"
	})
"Y" = (
/obj/stool/chair{
	dir = 1
	},
/obj/cable{
	icon_state = "1-8"
	},
/obj/machinery/light_switch/directional/east,
/turf/simulated/floor/redblack{
	dir = 1
	},
/area/station/crew_quarters/info{
	name = "Net Cafe"
	})
"Z" = (
/obj/machinery/firealarm/directional/south,
/obj/machinery/light_switch/directional/north,
/obj/cable{
	icon_state = "4-8"
	},
/turf/simulated/floor,
/area/station/crew_quarters/market)

(1,1,1) = {"
I
R
h
I
Z
I
q
H
I
"}
(2,1,1) = {"
A
m
j
x
i
d
j
m
t
"}
(3,1,1) = {"
A
B
W
r
T
Q
L
B
t
"}
(4,1,1) = {"
I
I
I
I
K
I
I
I
I
"}
(5,1,1) = {"
v
S
V
N
X
N
e
U
f
"}
(6,1,1) = {"
s
M
D
E
b
a
l
n
s
"}
(7,1,1) = {"
s
C
F
G
O
J
z
u
s
"}
(8,1,1) = {"
s
w
Y
k
g
P
p
o
s
"}
(9,1,1) = {"
N
N
N
N
y
N
N
N
N
"}
