//MAP CONVERTED BY dmm2tgm.py THIS HEADER COMMENT PREVENTS RECONVERSION, DO NOT REMOVE
"a" = (
/turf/simulated/wall/auto/supernorn/wood,
/area/station/crew_quarters/sauna)
"b" = (
/obj/cable{
	icon_state = "1-2"
	},
/turf/simulated/wall/auto/supernorn/colored,
/area/station/crew_quarters/sauna)
"c" = (
/obj/machinery/atmospherics/pipe/simple/junction{
	dir = 4
	},
/obj/machinery/light/small{
	dir = 1;
	pixel_y = 21
	},
/obj/storage/crate/freezer/milk,
/turf/simulated/floor/specialroom/freezer/blue,
/area/station/crew_quarters/kitchen/freezer)
"d" = (
/obj/cable{
	icon_state = "4-8"
	},
/obj/mapping_helper/firedoor_spawn,
/obj/machinery/door/airlock/pyro/alt{
	dir = 4
	},
/obj/mapping_helper/access/kitchen,
/turf/simulated/floor/specialroom/freezer/blue,
/area/station/crew_quarters/kitchen/freezer)
"f" = (
/obj/machinery/atmospherics/binary/volume_pump/active{
	dir = 4;
	transfer_rate = 1000
	},
/turf/simulated/wall/auto/supernorn/colored,
/area/station/crew_quarters/kitchen/freezer)
"g" = (
/obj/cable{
	icon_state = "4-8"
	},
/obj/machinery/door/unpowered/wood/pyro{
	dir = 4
	},
/turf/simulated/floor/wood/two,
/area/station/crew_quarters/sauna)
"h" = (
/obj/machinery/atmospherics/pipe/simple/heat_exchanging{
	dir = 9
	},
/obj/machinery/light/small{
	dir = 4;
	pixel_x = 12
	},
/obj/kitchenspike,
/turf/simulated/floor/specialroom/freezer/blue,
/area/station/crew_quarters/kitchen/freezer)
"i" = (
/obj/cable{
	icon_state = "4-8"
	},
/obj/cable{
	icon_state = "2-4"
	},
/obj/cable{
	icon_state = "2-8"
	},
/turf/simulated/wall/false_wall,
/area/station/crew_quarters/sauna)
"j" = (
/obj/machinery/atmospherics/pipe/simple/junction,
/obj/machinery/light_switch/directional/west,
/obj/cable{
	icon_state = "1-2"
	},
/turf/simulated/floor/plating/jen,
/area/station/crew_quarters/sauna)
"k" = (
/obj/machinery/atmospherics/pipe/simple/heat_exchanging{
	dir = 9
	},
/obj/machinery/drainage,
/obj/cable{
	icon_state = "4-8"
	},
/turf/simulated/floor/specialroom/freezer/blue,
/area/station/crew_quarters/kitchen/freezer)
"l" = (
/obj/stool/bench/sauna,
/obj/machinery/atmospherics/pipe/simple/heat_exchanging,
/turf/simulated/floor/wood/two,
/area/station/crew_quarters/sauna)
"m" = (
/obj/machinery/vending/monkey/kitchen,
/obj/decal/poster/wallsign/iso/warning/biological,
/turf/simulated/floor/specialroom/freezer/blue,
/area/station/crew_quarters/kitchen/freezer)
"o" = (
/obj/machinery/atmospherics/pipe/simple/heat_exchanging{
	dir = 4
	},
/obj/table/auto,
/obj/item/clothing/gloves/latex,
/obj/item/kitchen/utensil/knife,
/obj/item/kitchen/egg_box,
/turf/simulated/floor/specialroom/freezer/blue,
/area/station/crew_quarters/kitchen/freezer)
"p" = (
/obj/machinery/atmospherics/pipe/simple/heat_exchanging{
	dir = 1
	},
/obj/cable{
	icon_state = "2-8"
	},
/obj/cable{
	icon_state = "1-2"
	},
/turf/simulated/floor/wood/two,
/area/station/crew_quarters/sauna)
"q" = (
/obj/machinery/atmospherics/pipe/simple/heat_exchanging{
	dir = 5
	},
/obj/cable{
	icon_state = "1-2"
	},
/obj/machinery/light/small{
	dir = 8;
	pixel_x = -12
	},
/turf/simulated/floor/wood/two,
/area/station/crew_quarters/sauna)
"r" = (
/obj/machinery/atmospherics/pipe/simple/heat_exchanging{
	dir = 6
	},
/obj/machinery/power/apc/autoname_west,
/obj/cable{
	dir = null
	},
/obj/cable{
	icon_state = "1-4"
	},
/turf/simulated/floor/wood/two,
/area/station/crew_quarters/sauna)
"s" = (
/obj/machinery/atmospherics/pipe/simple/insulated/cold{
	can_rupture = 0;
	dir = 1
	},
/turf/simulated/wall/auto/supernorn/colored,
/area/station/crew_quarters/sauna)
"t" = (
/obj/machinery/atmospherics/pipe/simple/heat_exchanging{
	dir = 6
	},
/obj/cable{
	icon_state = "4-8"
	},
/turf/simulated/floor/specialroom/freezer/blue,
/area/station/crew_quarters/kitchen/freezer)
"u" = (
/obj/stool/bench/sauna,
/obj/machinery/atmospherics/pipe/simple/heat_exchanging,
/obj/cable{
	icon_state = "4-8"
	},
/turf/simulated/floor/wood/two,
/area/station/crew_quarters/sauna)
"v" = (
/obj/machinery/atmospherics/pipe/simple/heat_exchanging{
	dir = 9
	},
/obj/cable{
	icon_state = "4-8"
	},
/turf/simulated/floor/wood/two,
/area/station/crew_quarters/sauna)
"w" = (
/obj/machinery/atmospherics/pipe/simple/heat_exchanging{
	dir = 1
	},
/obj/cable{
	icon_state = "1-2"
	},
/obj/machinery/light_switch/directional/east,
/turf/simulated/floor/specialroom/freezer/blue,
/area/station/crew_quarters/kitchen/freezer)
"x" = (
/obj/machinery/atmospherics/unary/tank/carbon_dioxide,
/obj/machinery/light_switch/directional/east,
/obj/machinery/camera/directional/north,
/turf/simulated/floor/plating/jen,
/area/station/maintenance/storage)
"y" = (
/obj/machinery/portable_atmospherics/canister/air/large,
/obj/machinery/atmospherics/unary/portables_connector{
	dir = 2
	},
/obj/machinery/light/small{
	dir = 8;
	pixel_x = -12
	},
/obj/machinery/alarm/directional/north,
/turf/simulated/floor/plating/jen,
/area/station/maintenance/storage)
"z" = (
/obj/stool/bench/sauna{
	dir = 4
	},
/obj/machinery/atmospherics/pipe/simple/junction,
/turf/simulated/wall/auto/supernorn/wood,
/area/station/crew_quarters/sauna)
"A" = (
/obj/machinery/atmospherics/pipe/simple/heat_exchanging{
	dir = 1
	},
/obj/machinery/power/apc/autoname_east,
/obj/cable{
	dir = null
	},
/obj/cable{
	icon_state = "1-8"
	},
/turf/simulated/floor/specialroom/freezer/blue,
/area/station/crew_quarters/kitchen/freezer)
"B" = (
/obj/decal/poster/wallsign/iso/prohibited/food,
/obj/machinery/atmospherics/unary/furnace_connector,
/obj/machinery/power/furnace/thermo,
/turf/simulated/floor/plating/jen,
/area/station/crew_quarters/sauna)
"C" = (
/obj/machinery/atmospherics/pipe/simple/heat_exchanging{
	dir = 5
	},
/obj/storage/crate/furnacefuel,
/turf/simulated/floor/wood/two,
/area/station/crew_quarters/sauna)
"D" = (
/obj/machinery/atmospherics/pipe/simple/insulated/cold{
	can_rupture = 0;
	dir = 6
	},
/obj/cable{
	icon_state = "1-2"
	},
/obj/cable{
	icon_state = "1-8"
	},
/obj/landmark/antagonist/blob,
/turf/simulated/floor/plating/jen,
/area/station/maintenance/storage)
"E" = (
/obj/stool/bench/sauna{
	dir = 1
	},
/obj/machinery/atmospherics/pipe/simple/heat_exchanging{
	dir = 9
	},
/turf/simulated/floor/wood/two,
/area/station/crew_quarters/sauna)
"F" = (
/turf/simulated/wall/auto/supernorn/colored,
/area/station/crew_quarters/sauna)
"G" = (
/obj/machinery/atmospherics/pipe/manifold{
	dir = 4
	},
/obj/cable{
	icon_state = "4-8"
	},
/obj/landmark/pest,
/turf/simulated/floor/plating/jen,
/area/station/maintenance/storage)
"I" = (
/obj/machinery/atmospherics/pipe/simple/heat_exchanging{
	dir = 4
	},
/obj/machinery/light/small,
/turf/simulated/floor/wood/two,
/area/station/crew_quarters/sauna)
"J" = (
/obj/machinery/atmospherics/pipe/simple/insulated/cold{
	can_rupture = 0;
	dir = 5
	},
/turf/simulated/wall/auto/supernorn/colored,
/area/station/crew_quarters/sauna)
"K" = (
/obj/machinery/atmospherics/pipe/quadway/overfloor,
/obj/landmark/spawner/artifact,
/turf/simulated/floor/plating/jen,
/area/station/maintenance/storage)
"L" = (
/obj/machinery/atmospherics/unary/cold_sink/freezer/kitchen{
	dir = 1
	},
/obj/machinery/light/small{
	dir = 4;
	pixel_x = 12
	},
/turf/simulated/floor/plating/jen,
/area/station/maintenance/storage)
"M" = (
/obj/cable{
	icon_state = "1-2"
	},
/turf/simulated/floor/plating/jen,
/area/station/maintenance/storage)
"N" = (
/turf/simulated/wall/auto/supernorn/colored,
/area/station/maintenance/storage)
"O" = (
/obj/machinery/atmospherics/pipe/simple/heat_exchanging{
	dir = 1
	},
/obj/cable{
	icon_state = "2-4"
	},
/turf/simulated/floor/specialroom/freezer/blue,
/area/station/crew_quarters/kitchen/freezer)
"P" = (
/obj/machinery/atmospherics/pipe/simple/heat_exchanging{
	dir = 10
	},
/obj/storage/crate/freezer,
/turf/simulated/floor/specialroom/freezer/blue,
/area/station/crew_quarters/kitchen/freezer)
"Q" = (
/obj/machinery/atmospherics/pipe/simple/heat_exchanging{
	dir = 5
	},
/obj/machinery/gibber/output_south,
/turf/simulated/floor/specialroom/freezer/blue,
/area/station/crew_quarters/kitchen/freezer)
"R" = (
/obj/machinery/atmospherics/pipe/simple/junction,
/turf/simulated/floor/specialroom/freezer/blue,
/area/station/crew_quarters/kitchen/freezer)
"S" = (
/obj/machinery/atmospherics/pipe/simple{
	dir = 4
	},
/obj/cable{
	icon_state = "4-8"
	},
/turf/simulated/wall/false_wall,
/area/station/crew_quarters/sauna)
"T" = (
/obj/machinery/atmospherics/pipe/simple/insulated/cold{
	can_rupture = 0;
	dir = 10
	},
/obj/machinery/light/small{
	dir = 4;
	pixel_x = 12
	},
/turf/simulated/floor/specialroom/freezer/blue,
/area/station/crew_quarters/kitchen/freezer)
"U" = (
/obj/machinery/atmospherics/binary/valve/notify_admins{
	dir = 1;
	name = "Sauna Air Supply"
	},
/obj/machinery/power/apc/autoname_west,
/obj/cable{
	icon_state = "0-4"
	},
/turf/simulated/floor/plating/jen,
/area/station/maintenance/storage)
"V" = (
/turf/simulated/wall/auto/supernorn/colored,
/area/station/crew_quarters/kitchen/freezer)
"W" = (
/obj/machinery/atmospherics/binary/volume_pump/active{
	transfer_rate = 1000;
	dir = 1
	},
/obj/cable{
	icon_state = "1-8"
	},
/obj/machinery/space_heater,
/turf/simulated/floor/plating/jen,
/area/station/maintenance/storage)
"X" = (
/obj/machinery/atmospherics/pipe/manifold{
	dir = 8
	},
/obj/machinery/light/small{
	dir = 8;
	pixel_x = -12
	},
/obj/cable{
	icon_state = "2-4"
	},
/turf/simulated/floor/plating/jen,
/area/station/crew_quarters/sauna)
"Y" = (
/obj/cable{
	icon_state = "1-2"
	},
/obj/machinery/door/airlock/pyro/maintenance/alt,
/obj/mapping_helper/access/maint,
/obj/mapping_helper/firedoor_spawn,
/obj/mapping_helper/access/kitchen,
/turf/simulated/floor/plating/jen,
/area/station/maintenance/storage)
"Z" = (
/obj/machinery/atmospherics/pipe/simple/heat_exchanging{
	dir = 10
	},
/turf/simulated/floor/wood/two,
/area/station/crew_quarters/sauna)

(1,1,1) = {"
F
F
F
F
g
a
a
a
a
"}
(2,1,1) = {"
F
B
X
j
p
q
r
C
a
"}
(3,1,1) = {"
F
F
S
F
a
Z
v
I
a
"}
(4,1,1) = {"
N
y
G
U
z
l
u
E
a
"}
(5,1,1) = {"
Y
M
D
W
s
J
i
b
b
"}
(6,1,1) = {"
N
x
K
L
V
c
t
Q
V
"}
(7,1,1) = {"
V
V
f
V
V
P
k
o
V
"}
(8,1,1) = {"
V
m
T
R
O
w
A
h
V
"}
(9,1,1) = {"
V
V
V
V
d
V
V
V
V
"}
