//MAP CONVERTED BY dmm2tgm.py THIS HEADER COMMENT PREVENTS RECONVERSION, DO NOT REMOVE
"a" = (
/turf/simulated/wall/auto/reinforced/supernorn/colored/purple,
/area/station/science/testchamber)
"c" = (
/obj/machinery/firealarm/directional/north,
/obj/cable{
	icon_state = "4-8"
	},
/turf/simulated/floor/black,
/area/station/science/testchamber)
"d" = (
/obj/cable{
	icon_state = "1-2"
	},
/turf/simulated/wall/auto/reinforced/supernorn/colored/purple,
/area/station/science/testchamber)
"e" = (
/obj/item/storage/wall/fire{
	pixel_y = 31
	},
/turf/simulated/floor/black,
/area/station/science/testchamber)
"f" = (
/obj/machinery/optable,
/obj/item/clothing/gloves/latex{
	pixel_y = -2
	},
/obj/cable{
	icon_state = "1-2"
	},
/turf/simulated/floor/shuttlebay{
	name = "test chamber plating"
	},
/area/station/science/testchamber)
"g" = (
/obj/disposalpipe/segment/transport,
/obj/railing/reinforced,
/obj/table/reinforced/auto,
/obj/item/storage/box/syringes{
	pixel_x = 3;
	pixel_y = 3
	},
/obj/cable{
	icon_state = "1-2"
	},
/turf/simulated/floor/black,
/area/station/science/testchamber)
"h" = (
/obj/cable{
	icon_state = "4-8"
	},
/turf/simulated/floor/black,
/area/station/science/testchamber)
"i" = (
/obj/decal/poster/wallsign/iso/warning/generic{
	pixel_y = 4
	},
/turf/simulated/wall/auto/reinforced/supernorn/colored/purple,
/area/station/science/testchamber)
"j" = (
/obj/machinery/atmospherics/binary/pump/active{
	dir = 1;
	target_pressure = 250
	},
/obj/cable{
	icon_state = "1-2"
	},
/turf/simulated/floor/black,
/area/station/science/testchamber)
"k" = (
/obj/mapping_helper/wingrille_spawn/auto/reinforced/crystal,
/obj/cable{
	icon_state = "1-2"
	},
/obj/disposalpipe/segment/transport,
/turf/simulated/floor/plating,
/area/station/science/testchamber)
"m" = (
/obj/machinery/camera/directional/west,
/obj/machinery/sink{
	dir = 4
	},
/turf/simulated/floor/black,
/area/station/science/testchamber)
"n" = (
/obj/machinery/atmospherics/unary/outlet_injector/active{
	dir = 4
	},
/obj/cable{
	icon_state = "1-2"
	},
/turf/simulated/floor/shuttlebay{
	name = "test chamber plating"
	},
/area/station/science/testchamber)
"p" = (
/obj/cable{
	icon_state = "2-8"
	},
/turf/simulated/floor/black,
/area/station/science/testchamber)
"r" = (
/obj/machinery/light/incandescent/cool/very{
	dir = 1
	},
/obj/cable{
	icon_state = "1-2"
	},
/turf/simulated/floor/shuttlebay{
	name = "test chamber plating"
	},
/area/station/science/testchamber)
"s" = (
/obj/disposalpipe/segment/transport,
/obj/cable{
	icon_state = "2-4"
	},
/obj/cable{
	icon_state = "2-8"
	},
/obj/cable{
	icon_state = "1-2"
	},
/turf/simulated/floor/black,
/area/station/science/testchamber)
"t" = (
/obj/disposaloutlet{
	dir = 1;
	pixel_y = -19;
	layer = 2.0
	},
/obj/decal/stripe_delivery,
/obj/cable{
	icon_state = "1-2"
	},
/obj/disposalpipe/trunk/transport,
/turf/simulated/floor/shuttlebay{
	name = "test chamber plating"
	},
/area/station/science/testchamber)
"v" = (
/obj/machinery/door/airlock/pyro/sci_alt{
	dir = 4;
	id = "testchamber"
	},
/obj/mapping_helper/access/research,
/obj/mapping_helper/firedoor_spawn,
/obj/cable{
	icon_state = "4-8"
	},
/turf/simulated/floor/black,
/area/station/science/testchamber)
"y" = (
/obj/mapping_helper/wingrille_spawn/auto/reinforced/crystal,
/turf/simulated/floor/plating,
/area/station/science/testchamber)
"z" = (
/obj/cable{
	icon_state = "1-2"
	},
/obj/machinery/light_switch/directional/west,
/turf/simulated/floor/black,
/area/station/science/testchamber)
"B" = (
/obj/machinery/atmospherics/unary/portables_connector{
	dir = 1
	},
/turf/simulated/floor/black,
/area/station/science/testchamber)
"C" = (
/obj/stool/chair/office{
	dir = 4
	},
/obj/machinery/light{
	dir = 8
	},
/turf/simulated/floor/black,
/area/station/science/testchamber)
"D" = (
/obj/item/storage/wall/medical{
	pixel_y = 32
	},
/turf/simulated/floor/black,
/area/station/science/testchamber)
"F" = (
/obj/machinery/light,
/turf/simulated/floor/black,
/area/station/science/testchamber)
"G" = (
/obj/railing/reinforced,
/obj/table/reinforced/auto,
/obj/item/chem_grenade/firefighting{
	pixel_x = 7;
	pixel_y = 6
	},
/obj/item/hand_labeler{
	pixel_x = -7
	},
/turf/simulated/floor/black,
/area/station/science/testchamber)
"H" = (
/obj/machinery/atmospherics/binary/valve,
/obj/cable{
	icon_state = "1-8"
	},
/obj/machinery/camera/directional/east,
/turf/simulated/floor/black,
/area/station/science/testchamber)
"J" = (
/obj/machinery/atmospherics/pipe/simple/overfloor{
	dir = 4
	},
/turf/simulated/floor/shuttlebay{
	name = "test chamber plating"
	},
/area/station/science/testchamber)
"M" = (
/obj/machinery/atmospherics/pipe/simple/overfloor,
/obj/cable{
	icon_state = "2-4"
	},
/turf/simulated/floor/black,
/area/station/science/testchamber)
"N" = (
/turf/simulated/floor/black,
/area/station/science/testchamber)
"O" = (
/obj/stool/chair/office{
	dir = 8
	},
/obj/machinery/atmospherics/pipe/simple/overfloor{
	dir = 10
	},
/obj/machinery/light{
	dir = 4
	},
/turf/simulated/floor/black,
/area/station/science/testchamber)
"P" = (
/obj/mapping_helper/wingrille_spawn/auto/reinforced/crystal,
/obj/machinery/atmospherics/pipe/simple/overfloor{
	dir = 4
	},
/turf/simulated/floor/plating,
/area/station/science/testchamber)
"Q" = (
/obj/machinery/door/airlock/pyro/sci_alt{
	dir = 4;
	id = "testchamber"
	},
/obj/mapping_helper/access/research,
/obj/mapping_helper/firedoor_spawn,
/turf/simulated/floor/shuttlebay{
	name = "test chamber plating"
	},
/area/station/science/testchamber)
"R" = (
/obj/railing/reinforced,
/obj/table/reinforced/auto,
/obj/item/device/analyzer/healthanalyzer,
/obj/item/clothing/glasses/sunglasses{
	pixel_y = 10
	},
/turf/simulated/floor/black,
/area/station/science/testchamber)
"S" = (
/obj/machinery/power/apc/autoname_west,
/obj/cable{
	icon_state = "1-4"
	},
/obj/cable{
	icon_state = "0-4"
	},
/turf/simulated/floor/black,
/area/station/science/testchamber)
"T" = (
/obj/machinery/floorflusher/industrial{
	name = "test chamber chute"
	},
/obj/disposalpipe/trunk/transport{
	dir = 1
	},
/obj/cable{
	icon_state = "1-2"
	},
/turf/simulated/floor/black,
/area/station/science/testchamber)
"U" = (
/turf/simulated/floor/shuttlebay{
	name = "test chamber plating"
	},
/area/station/science/testchamber)
"V" = (
/obj/machinery/door_control/bolter{
	pixel_y = 28;
	id = "testchamber"
	},
/obj/cable{
	icon_state = "4-8"
	},
/turf/simulated/floor/black,
/area/station/science/testchamber)
"Z" = (
/obj/machinery/camera/directional/north,
/turf/simulated/floor/shuttlebay{
	name = "test chamber plating"
	},
/area/station/science/testchamber)

(1,1,1) = {"
a
a
a
a
v
a
a
a
a
"}
(2,1,1) = {"
a
D
N
C
p
z
S
m
a
"}
(3,1,1) = {"
a
y
Q
y
y
a
V
F
a
"}
(4,1,1) = {"
a
Z
U
U
U
y
h
R
i
"}
(5,1,1) = {"
d
r
f
n
t
k
s
g
T
"}
(6,1,1) = {"
a
U
U
J
U
y
h
G
i
"}
(7,1,1) = {"
a
y
Q
P
y
a
c
F
a
"}
(8,1,1) = {"
a
e
N
O
M
j
H
B
a
"}
(9,1,1) = {"
a
a
a
a
v
a
a
a
a
"}
