//MAP CONVERTED BY dmm2tgm.py THIS HEADER COMMENT PREVENTS RECONVERSION, DO NOT REMOVE
"ac" = (
/obj/machinery/atmospherics/binary/circulatorTemp/right,
/obj/decal/tile_edge/stripe/extra_big,
/obj/decal/tile_edge/stripe/extra_big{
	dir = 1
	},
/turf/simulated/floor,
/area/station/engine/core/thermoelectric)
"ag" = (
/obj/item/extinguisher,
/obj/machinery/atmospherics/pipe/simple/insulated/cold,
/obj/decal/stripe_delivery,
/obj/cable/orange{
	icon_state = "2-8"
	},
/turf/simulated/floor/engine,
/area/station/engine/core/thermoelectric)
"as" = (
/obj/item/device/radio/intercom{
	dir = 1;
	frequency = 1448;
	name = "Toxins Lab Intercom"
	},
/obj/machinery/atmospherics/unary/portables_connector{
	dir = 8
	},
/obj/cable{
	icon_state = "1-4"
	},
/turf/simulated/floor/engine,
/area/station/engine/core/thermoelectric)
"bf" = (
/obj/machinery/atmospherics/pipe/manifold{
	dir = 8;
	level = 2
	},
/obj/machinery/meter{
	pixel_y = -9;
	pixel_x = 10
	},
/obj/cable/orange{
	icon_state = "1-2"
	},
/turf/simulated/floor/engine,
/area/station/engine/core/thermoelectric)
"bM" = (
/obj/cable{
	icon_state = "0-2"
	},
/obj/mapping_helper/wingrille_spawn/auto/reinforced,
/turf/simulated/floor/plating,
/area/station/engine/core/thermoelectric)
"dq" = (
/obj/mapping_helper/wingrille_spawn/auto/reinforced,
/obj/cable{
	icon_state = "0-4"
	},
/obj/cable,
/turf/simulated/floor/plating,
/area/station/engine/core/thermoelectric)
"em" = (
/obj/cable{
	icon_state = "0-2"
	},
/obj/cable{
	icon_state = "0-8"
	},
/obj/mapping_helper/wingrille_spawn/auto/reinforced,
/obj/cable{
	icon_state = "0-4"
	},
/turf/simulated/floor/plating,
/area/station/engine/core/thermoelectric)
"eq" = (
/obj/machinery/atmospherics/pipe/simple/insulated/cold{
	dir = 6
	},
/obj/machinery/meter{
	pixel_x = 8;
	pixel_y = -7
	},
/turf/simulated/floor/engine,
/area/station/engine/core/thermoelectric)
"ez" = (
/obj/machinery/atmospherics/pipe/simple/insulated/cold{
	dir = 4
	},
/turf/simulated/floor/engine,
/area/station/engine/core/thermoelectric)
"eH" = (
/obj/mapping_helper/wingrille_spawn/auto/reinforced,
/obj/cable,
/obj/cable{
	icon_state = "0-8"
	},
/turf/simulated/floor/plating,
/area/station/engine/core/thermoelectric)
"eN" = (
/obj/machinery/power/apc/autoname_north,
/obj/cable{
	icon_state = "0-2"
	},
/obj/cable{
	icon_state = "0-8"
	},
/obj/machinery/atmospherics/binary/valve{
	dir = 4;
	name = "hot inlet valve"
	},
/turf/simulated/floor/engine,
/area/station/engine/core/thermoelectric)
"eZ" = (
/obj/cable/orange{
	icon_state = "1-2"
	},
/obj/storage/crate/furnacefuel,
/turf/simulated/floor/engine,
/area/station/engine/core/thermoelectric)
"fX" = (
/obj/mapping_helper/wingrille_spawn/auto/reinforced,
/obj/cable{
	icon_state = "0-2"
	},
/turf/simulated/floor/plating,
/area/station/engine/core/thermoelectric)
"gC" = (
/obj/decal/stripe_delivery,
/obj/stool/chair{
	dir = 1
	},
/obj/cable/orange{
	icon_state = "1-4"
	},
/obj/landmark/start{
	name = "Engineer"
	},
/turf/simulated/floor/engine,
/area/station/engine/core/thermoelectric)
"hn" = (
/obj/mapping_helper/wingrille_spawn/auto/reinforced,
/obj/cable{
	icon_state = "0-2"
	},
/obj/cable,
/turf/simulated/floor/plating,
/area/station/engine/core/thermoelectric)
"hw" = (
/obj/machinery/light/small{
	dir = 1;
	pixel_y = 21
	},
/obj/decal/tile_edge/stripe/extra_big{
	dir = 1
	},
/turf/simulated/floor/grey/side,
/area/station/engine/inner)
"hU" = (
/obj/machinery/firealarm/directional/south{
	layer = 3.5
	},
/obj/machinery/atmospherics/binary/valve{
	dir = 4;
	name = "cold auxillary valve"
	},
/turf/simulated/floor/engine,
/area/station/engine/core/thermoelectric)
"ir" = (
/obj/cable{
	icon_state = "4-8"
	},
/obj/cable{
	icon_state = "2-4"
	},
/turf/simulated/floor/engine,
/area/station/engine/core/thermoelectric)
"iC" = (
/obj/machinery/atmospherics/binary/valve{
	name = "cold outlet valve";
	dir = 8
	},
/turf/simulated/floor/engine,
/area/station/engine/core/thermoelectric)
"iO" = (
/obj/machinery/atmospherics/binary/valve{
	dir = 4;
	name = "hot auxillary valve"
	},
/turf/simulated/floor/engine,
/area/station/engine/core/thermoelectric)
"jH" = (
/obj/mapping_helper/wingrille_spawn/auto/reinforced,
/obj/cable,
/obj/cable{
	icon_state = "0-2"
	},
/turf/simulated/floor/plating,
/area/station/engine/core/thermoelectric)
"kF" = (
/obj/machinery/atmospherics/unary/furnace_connector{
	dir = 4
	},
/obj/machinery/power/furnace/thermo,
/obj/cable{
	icon_state = "4-8"
	},
/turf/simulated/floor/engine,
/area/station/engine/core/thermoelectric)
"lQ" = (
/obj/machinery/atmospherics/pipe/simple/insulated{
	dir = 10
	},
/obj/machinery/meter{
	pixel_x = -8;
	pixel_y = -7
	},
/turf/simulated/floor/engine,
/area/station/engine/core/thermoelectric)
"no" = (
/obj/cable{
	icon_state = "0-2"
	},
/obj/cable{
	icon_state = "0-4"
	},
/obj/mapping_helper/wingrille_spawn/auto/reinforced,
/obj/cable{
	icon_state = "0-8"
	},
/turf/simulated/floor/plating,
/area/station/engine/core/thermoelectric)
"nW" = (
/obj/cable{
	icon_state = "4-8"
	},
/obj/cable{
	icon_state = "1-4"
	},
/turf/simulated/floor/engine,
/area/station/engine/core/thermoelectric)
"oO" = (
/obj/machinery/atmospherics/pipe/simple/insulated,
/obj/machinery/power/stats_meter{
	name = "Hot Loop Outlet Meter";
	pixel_x = -12;
	tag = "Hot Loop Outlet Meter"
	},
/obj/cable{
	icon_state = "4-8"
	},
/turf/simulated/floor/engine,
/area/station/engine/core/thermoelectric)
"pa" = (
/obj/machinery/atmospherics/binary/passive_gate/opened{
	dir = 8;
	target_pressure = 1e+031
	},
/turf/simulated/wall/auto/reinforced/supernorn,
/area/station/engine/core/thermoelectric)
"pc" = (
/obj/machinery/atmospherics/binary/valve{
	name = "hot purge valve"
	},
/turf/simulated/floor/grey,
/area/station/engine/inner)
"qm" = (
/obj/machinery/atmospherics/pipe/simple/insulated/cold{
	dir = 5
	},
/obj/cable{
	icon_state = "2-8"
	},
/obj/cable{
	icon_state = "4-8"
	},
/turf/simulated/floor/engine,
/area/station/engine/core/thermoelectric)
"ri" = (
/obj/machinery/atmospherics/pipe/manifold{
	dir = 8;
	level = 2
	},
/obj/cable/orange{
	icon_state = "1-2"
	},
/turf/simulated/floor/engine,
/area/station/engine/core/thermoelectric)
"rB" = (
/obj/machinery/light/emergency{
	dir = 1;
	pixel_y = 16
	},
/turf/simulated/floor/grey,
/area/station/engine/inner)
"rI" = (
/obj/machinery/door/airlock/pyro/glass/engineering{
	name = "Core Access";
	req_access = null
	},
/obj/mapping_helper/access/engineering_engine,
/obj/mapping_helper/firedoor_spawn,
/obj/decal/stripe_delivery,
/turf/simulated/floor/engine,
/area/station/engine/core/thermoelectric)
"sq" = (
/obj/cable/orange{
	icon_state = "1-2"
	},
/obj/machinery/light{
	dir = 1;
	layer = 9.1;
	pixel_y = 21
	},
/turf/simulated/floor/engine,
/area/station/engine/core/thermoelectric)
"sZ" = (
/obj/machinery/atmospherics/binary/passive_gate/opened{
	target_pressure = 1e+031
	},
/turf/simulated/floor/engine,
/area/station/engine/core/thermoelectric)
"uc" = (
/obj/machinery/atmospherics/pipe/simple/insulated{
	dir = 4
	},
/turf/simulated/floor/engine,
/area/station/engine/core/thermoelectric)
"uK" = (
/obj/machinery/light/small,
/obj/decal/tile_edge/stripe/extra_big,
/turf/simulated/floor/grey/side{
	dir = 1
	},
/area/station/engine/inner)
"vv" = (
/obj/machinery/atmospherics/pipe/simple/insulated{
	dir = 9
	},
/obj/cable{
	icon_state = "4-8"
	},
/obj/cable{
	icon_state = "2-4"
	},
/turf/simulated/floor/engine,
/area/station/engine/core/thermoelectric)
"vN" = (
/obj/machinery/atmospherics/pipe/simple/insulated,
/obj/machinery/door/airlock/pyro/glass/engineering{
	name = "Core Access";
	req_access = null
	},
/obj/mapping_helper/access/engineering_engine,
/obj/mapping_helper/firedoor_spawn,
/obj/decal/stripe_delivery,
/turf/simulated/floor/engine,
/area/station/engine/core/thermoelectric)
"vR" = (
/obj/machinery/portable_atmospherics/pump,
/obj/machinery/light/small{
	dir = 1;
	pixel_y = 21
	},
/obj/decal/tile_edge/stripe/extra_big{
	dir = 1
	},
/turf/simulated/floor/grey/side,
/area/station/engine/inner)
"vS" = (
/obj/machinery/power/generatorTemp,
/obj/item/paper/engine,
/obj/decal/tile_edge/stripe/extra_big,
/obj/cable/orange{
	icon_state = "0-2"
	},
/obj/cable/orange,
/obj/decal/tile_edge/stripe/extra_big{
	dir = 1
	},
/turf/simulated/floor,
/area/station/engine/core/thermoelectric)
"wQ" = (
/obj/machinery/atmospherics/binary/valve{
	dir = 4;
	name = "cold inlet valve"
	},
/turf/simulated/wall/auto/reinforced/supernorn,
/area/station/engine/core/thermoelectric)
"xs" = (
/obj/machinery/atmospherics/pipe/simple/insulated/cold,
/obj/machinery/power/stats_meter{
	name = "Cold Loop Inlet Meter";
	pixel_x = 12;
	tag = "Cold Loop Inlet Meter"
	},
/turf/simulated/floor/engine,
/area/station/engine/core/thermoelectric)
"xv" = (
/obj/machinery/atmospherics/unary/furnace_connector{
	dir = 4
	},
/obj/machinery/power/furnace/thermo,
/turf/simulated/floor/engine,
/area/station/engine/core/thermoelectric)
"yD" = (
/obj/cable{
	icon_state = "4-8"
	},
/obj/cable{
	icon_state = "1-8"
	},
/turf/simulated/floor/engine,
/area/station/engine/core/thermoelectric)
"yZ" = (
/obj/machinery/atmospherics/pipe/simple/insulated/cold,
/obj/machinery/door/airlock/pyro/glass/engineering{
	name = "Core Access";
	req_access = null
	},
/obj/mapping_helper/access/engineering_engine,
/obj/mapping_helper/firedoor_spawn,
/obj/cable/orange{
	icon_state = "1-2"
	},
/obj/decal/stripe_delivery,
/turf/simulated/floor/engine,
/area/station/engine/core/thermoelectric)
"zn" = (
/obj/machinery/atmospherics/pipe/simple/insulated/cold{
	dir = 4
	},
/obj/cable{
	icon_state = "1-2"
	},
/turf/simulated/floor/engine,
/area/station/engine/core/thermoelectric)
"zx" = (
/obj/machinery/atmospherics/unary/portables_connector{
	dir = 4
	},
/obj/item/device/radio/intercom/engineering{
	dir = 1
	},
/obj/cable{
	icon_state = "1-8"
	},
/turf/simulated/floor/engine,
/area/station/engine/core/thermoelectric)
"zQ" = (
/obj/cable{
	icon_state = "1-2"
	},
/obj/machinery/light/small/floor/warm,
/turf/simulated/floor/engine,
/area/station/engine/core/thermoelectric)
"AM" = (
/obj/cable{
	icon_state = "0-4"
	},
/obj/mapping_helper/wingrille_spawn/auto/reinforced,
/turf/simulated/floor/plating,
/area/station/engine/core/thermoelectric)
"Bi" = (
/obj/machinery/atmospherics/pipe/simple/insulated,
/obj/decal/stripe_delivery,
/turf/simulated/floor/engine,
/area/station/engine/core/thermoelectric)
"Bm" = (
/obj/cable{
	icon_state = "1-2"
	},
/turf/simulated/floor/engine,
/area/station/engine/core/thermoelectric)
"Bp" = (
/obj/machinery/light/small{
	dir = 1;
	pixel_y = 21
	},
/obj/cable{
	icon_state = "1-2"
	},
/turf/simulated/floor/grey,
/area/station/engine/inner)
"Cv" = (
/obj/machinery/atmospherics/pipe/simple/insulated{
	dir = 1
	},
/obj/machinery/power/stats_meter{
	name = "Hot Loop Inlet Meter";
	pixel_x = -12;
	tag = "Hot Loop Inlet Meter"
	},
/turf/simulated/floor/engine,
/area/station/engine/core/thermoelectric)
"CP" = (
/obj/machinery/light,
/obj/cable{
	icon_state = "1-2"
	},
/turf/simulated/floor/engine,
/area/station/engine/core/thermoelectric)
"DK" = (
/obj/machinery/atmospherics/pipe/manifold{
	dir = 4;
	level = 2
	},
/turf/simulated/floor/engine,
/area/station/engine/core/thermoelectric)
"EC" = (
/turf/simulated/wall/auto/reinforced/supernorn,
/area/station/engine/core/thermoelectric)
"Fd" = (
/obj/machinery/atmospherics/pipe/simple/insulated{
	dir = 4
	},
/obj/cable{
	icon_state = "1-2"
	},
/turf/simulated/floor/engine,
/area/station/engine/core/thermoelectric)
"FE" = (
/obj/cable{
	icon_state = "0-8"
	},
/obj/cable,
/obj/mapping_helper/wingrille_spawn/auto/reinforced,
/obj/cable{
	icon_state = "0-4"
	},
/turf/simulated/floor/plating,
/area/station/engine/core/thermoelectric)
"Gz" = (
/obj/cable,
/obj/mapping_helper/wingrille_spawn/auto/reinforced,
/turf/simulated/floor/plating,
/area/station/engine/core/thermoelectric)
"Hs" = (
/obj/machinery/light/small,
/obj/machinery/portable_atmospherics/scrubber,
/obj/decal/tile_edge/stripe/extra_big,
/turf/simulated/floor/grey/side{
	dir = 1
	},
/area/station/engine/inner)
"If" = (
/obj/cable{
	icon_state = "0-8"
	},
/obj/mapping_helper/wingrille_spawn/auto/reinforced,
/turf/simulated/floor/plating,
/area/station/engine/core/thermoelectric)
"Jl" = (
/obj/machinery/firealarm/directional/north,
/obj/cable{
	icon_state = "2-4"
	},
/obj/machinery/atmospherics/binary/valve{
	dir = 4;
	name = "cold inlet valve"
	},
/turf/simulated/floor/engine,
/area/station/engine/core/thermoelectric)
"JD" = (
/obj/cable/orange{
	icon_state = "1-2"
	},
/turf/simulated/floor/engine,
/area/station/engine/core/thermoelectric)
"Kh" = (
/obj/machinery/atmospherics/binary/passive_gate/opened{
	dir = 4;
	target_pressure = 1e+031
	},
/turf/simulated/wall/auto/reinforced/supernorn,
/area/station/engine/core/thermoelectric)
"Kx" = (
/turf/simulated/floor/grey,
/area/station/engine/inner)
"KR" = (
/obj/machinery/atmospherics/unary/cold_sink/freezer{
	dir = 8
	},
/turf/simulated/floor/engine,
/area/station/engine/core/thermoelectric)
"LC" = (
/obj/cable{
	icon_state = "0-4"
	},
/obj/cable,
/obj/mapping_helper/wingrille_spawn/auto/reinforced,
/obj/cable{
	icon_state = "0-8"
	},
/turf/simulated/floor/plating,
/area/station/engine/core/thermoelectric)
"LD" = (
/obj/machinery/atmospherics/pipe/simple/insulated/cold,
/obj/machinery/power/stats_meter{
	name = "Cold Loop Outlet Meter";
	pixel_x = 12;
	tag = "Cold Loop Outlet Meter"
	},
/obj/cable{
	icon_state = "4-8"
	},
/obj/cable/orange{
	icon_state = "1-2"
	},
/turf/simulated/floor/engine,
/area/station/engine/core/thermoelectric)
"OQ" = (
/obj/machinery/atmospherics/binary/valve{
	name = "cold purge valve"
	},
/obj/cable/orange{
	icon_state = "1-2"
	},
/turf/simulated/floor/grey,
/area/station/engine/inner)
"PX" = (
/obj/machinery/atmospherics/binary/valve{
	dir = 4;
	name = "hot inlet valve"
	},
/turf/simulated/wall/auto/reinforced/supernorn,
/area/station/engine/core/thermoelectric)
"Ru" = (
/obj/decal/stripe_delivery,
/turf/simulated/floor/grey,
/area/station/engine/inner)
"Rw" = (
/obj/machinery/atmospherics/unary/cold_sink/freezer{
	dir = 8
	},
/obj/cable{
	icon_state = "4-8"
	},
/turf/simulated/floor/engine,
/area/station/engine/core/thermoelectric)
"Sf" = (
/obj/cable/orange{
	icon_state = "1-2"
	},
/obj/mapping_helper/wingrille_spawn/auto/reinforced,
/turf/simulated/floor/plating,
/area/station/engine/core/thermoelectric)
"TN" = (
/obj/machinery/camera/directional/north{
	pixel_x = -10
	},
/obj/machinery/atmospherics/pipe/simple/insulated/cold{
	dir = 10
	},
/obj/cable{
	icon_state = "4-8"
	},
/turf/simulated/floor/engine,
/area/station/engine/core/thermoelectric)
"WO" = (
/obj/machinery/atmospherics/pipe/manifold{
	dir = 8;
	level = 2
	},
/turf/simulated/floor/engine,
/area/station/engine/core/thermoelectric)
"WR" = (
/obj/machinery/atmospherics/binary/valve{
	dir = 4;
	name = "hot outlet valve"
	},
/turf/simulated/floor/engine,
/area/station/engine/core/thermoelectric)
"Xc" = (
/obj/machinery/atmospherics/pipe/manifold{
	dir = 4;
	level = 2
	},
/obj/machinery/meter{
	pixel_y = -9;
	pixel_x = -9
	},
/turf/simulated/floor/engine,
/area/station/engine/core/thermoelectric)
"Yg" = (
/obj/machinery/light_switch/directional/north,
/obj/machinery/atmospherics/pipe/simple/insulated{
	dir = 6
	},
/obj/cable{
	icon_state = "4-8"
	},
/turf/simulated/floor/engine,
/area/station/engine/core/thermoelectric)
"ZF" = (
/obj/machinery/atmospherics/binary/circulatorTemp,
/obj/decal/tile_edge/stripe/extra_big,
/obj/decal/tile_edge/stripe/extra_big{
	dir = 1
	},
/turf/simulated/floor,
/area/station/engine/core/thermoelectric)

(1,1,1) = {"
uK
AM
PX
fX
hn
hn
dq
pa
AM
hw
Kx
"}
(2,1,1) = {"
bM
FE
uc
xv
xv
xv
kF
WR
em
Gz
Kx
"}
(3,1,1) = {"
EC
Yg
DK
DK
DK
DK
vv
Fd
zx
EC
rB
"}
(4,1,1) = {"
EC
eN
Bm
Bm
zQ
Bm
nW
uc
iO
EC
Ru
"}
(5,1,1) = {"
rI
lQ
sZ
Cv
ZF
Bi
oO
Xc
DK
vN
pc
"}
(6,1,1) = {"
Sf
sq
JD
eZ
vS
gC
ir
Bm
CP
jH
Bp
"}
(7,1,1) = {"
rI
eq
sZ
xs
ac
ag
LD
bf
ri
yZ
OQ
"}
(8,1,1) = {"
EC
Jl
Bm
Bm
zQ
Bm
yD
ez
hU
EC
Ru
"}
(9,1,1) = {"
EC
TN
WO
WO
WO
WO
qm
zn
as
EC
rB
"}
(10,1,1) = {"
bM
LC
ez
KR
KR
KR
Rw
iC
no
Gz
Kx
"}
(11,1,1) = {"
Hs
If
wQ
fX
jH
jH
eH
Kh
If
vR
Kx
"}
