//MAP CONVERTED BY dmm2tgm.py THIS HEADER COMMENT PREVENTS RECONVERSION, DO NOT REMOVE
"a" = (
/turf/simulated/wall/auto/asteroid/lighted,
/area/space)
"g" = (
/turf/space,
/area/space)
"h" = (
/obj/item/raw_material/cobryl,
/obj/item/raw_material/cobryl,
/obj/item/raw_material/cobryl,
/obj/item/raw_material/pharosium,
/turf/simulated/floor/plating/airless/asteroid/lighted,
/area/space)
"k" = (
/obj/item/raw_material/syreline,
/mob/living/critter/fermid,
/turf/simulated/floor/plating/airless/asteroid/lighted,
/area/space)
"m" = (
/obj/item/raw_material/cobryl,
/obj/item/raw_material/pharosium,
/turf/simulated/floor/plating/airless/asteroid/lighted,
/area/space)
"q" = (
/obj/item/raw_material/cobryl,
/obj/item/raw_material/pharosium,
/mob/living/critter/fermid,
/turf/simulated/floor/plating/airless/asteroid/lighted,
/area/space)
"r" = (
/obj/item/raw_material/cobryl,
/obj/item/raw_material/cobryl,
/turf/simulated/floor/plating/airless/asteroid/lighted,
/area/space)
"u" = (
/obj/item/raw_material/syreline,
/obj/item/raw_material/syreline,
/mob/living/critter/fermid,
/turf/simulated/floor/plating/airless/asteroid/lighted,
/area/space)
"B" = (
/obj/item/raw_material/syreline,
/obj/item/raw_material/syreline,
/turf/simulated/floor/plating/airless/asteroid/lighted,
/area/space)
"C" = (
/obj/item/raw_material/pharosium,
/turf/simulated/floor/plating/airless/asteroid/lighted,
/area/space)
"D" = (
/mob/living/critter/fermid,
/turf/simulated/floor/plating/airless/asteroid/lighted,
/area/space)
"G" = (
/obj/item/raw_material/syreline,
/obj/item/raw_material/pharosium,
/turf/simulated/floor/plating/airless/asteroid/lighted,
/area/space)
"H" = (
/turf/simulated/floor/plating/airless/asteroid/lighted,
/area/space)
"J" = (
/obj/landmark/spawner/artifact,
/turf/simulated/floor/plating/airless/asteroid/lighted,
/area/space)
"N" = (
/obj/item/raw_material/cobryl,
/turf/simulated/floor/plating/airless/asteroid/lighted,
/area/space)
"O" = (
/obj/item/raw_material/syreline,
/obj/item/raw_material/cobryl,
/turf/simulated/floor/plating/airless/asteroid/lighted,
/area/space)
"T" = (
/obj/item/raw_material/gold,
/mob/living/critter/fermid,
/turf/simulated/floor/plating/airless/asteroid/lighted,
/area/space)
"U" = (
/obj/item/raw_material/syreline,
/turf/simulated/floor/plating/airless/asteroid/lighted,
/area/space)
"V" = (
/obj/item/raw_material/cobryl,
/obj/item/raw_material/cobryl,
/obj/item/raw_material/cobryl,
/turf/simulated/floor/plating/airless/asteroid/lighted,
/area/space)

(1,1,1) = {"
g
g
g
g
g
g
g
g
g
g
g
a
a
a
a
a
g
g
g
g
g
g
g
g
g
g
g
g
g
g
g
g
"}
(2,1,1) = {"
g
g
g
g
g
g
g
g
g
g
g
g
a
a
a
a
g
g
g
g
g
g
g
g
g
g
g
g
g
g
g
g
"}
(3,1,1) = {"
g
g
g
g
g
g
g
g
g
g
g
g
g
a
g
g
g
g
g
g
g
g
g
g
g
g
g
g
g
g
g
g
"}
(4,1,1) = {"
g
g
g
g
g
g
g
g
g
g
g
g
g
g
g
g
g
g
g
g
g
g
g
g
g
g
g
g
g
g
g
g
"}
(5,1,1) = {"
g
g
a
a
a
a
g
g
g
g
g
g
g
g
g
g
g
g
g
g
a
g
g
g
g
g
g
g
g
g
g
g
"}
(6,1,1) = {"
g
g
a
a
a
g
g
g
g
g
g
g
g
g
g
a
g
g
g
a
a
a
g
g
g
g
g
g
a
a
a
g
"}
(7,1,1) = {"
g
g
a
g
g
g
g
g
g
g
g
g
a
a
a
a
a
g
g
g
a
a
a
g
g
g
g
a
a
a
a
a
"}
(8,1,1) = {"
g
g
g
g
g
g
g
g
g
g
a
H
a
a
a
a
a
a
g
g
g
g
a
g
g
g
g
a
a
a
a
a
"}
(9,1,1) = {"
g
g
g
g
g
g
a
a
g
g
a
H
a
a
a
g
g
g
g
g
g
g
g
g
g
g
a
a
a
a
a
a
"}
(10,1,1) = {"
g
g
g
g
g
a
a
a
a
a
a
H
N
a
a
a
a
a
g
g
g
g
g
g
g
g
g
g
a
a
a
a
"}
(11,1,1) = {"
g
g
g
g
a
a
B
u
H
H
H
N
N
U
a
a
a
U
g
a
g
g
g
g
g
g
g
g
a
a
a
a
"}
(12,1,1) = {"
g
g
g
a
a
a
a
B
a
a
a
a
H
a
a
a
a
H
a
a
a
g
g
g
g
g
g
g
g
a
a
g
"}
(13,1,1) = {"
g
g
g
g
g
g
a
a
a
H
H
H
D
a
a
a
a
H
a
a
a
a
g
g
g
g
g
g
g
g
g
g
"}
(14,1,1) = {"
g
g
g
g
g
g
g
a
a
C
a
a
a
a
O
m
C
C
a
a
a
a
g
g
g
g
g
g
g
g
g
g
"}
(15,1,1) = {"
g
g
g
g
g
g
g
a
a
H
a
U
U
H
m
q
a
a
a
T
H
a
a
a
a
g
g
g
g
g
g
g
"}
(16,1,1) = {"
g
g
g
g
g
g
g
a
a
H
a
a
a
a
C
a
a
a
a
a
U
a
H
H
a
g
g
g
g
g
g
g
"}
(17,1,1) = {"
g
g
g
g
g
g
g
g
a
H
N
V
r
a
C
a
U
U
a
a
U
H
H
a
a
g
g
g
g
g
g
g
"}
(18,1,1) = {"
g
g
g
g
g
g
g
a
a
a
H
h
h
a
H
a
G
C
H
H
k
a
a
a
g
g
g
g
g
g
g
g
"}
(19,1,1) = {"
a
g
g
g
g
g
g
a
a
a
D
H
N
H
H
D
H
C
a
a
a
a
a
g
g
g
g
g
g
g
g
g
"}
(20,1,1) = {"
a
a
g
g
g
g
g
g
a
a
H
C
a
a
a
a
a
a
a
a
a
g
a
g
g
g
g
g
g
g
g
g
"}
(21,1,1) = {"
a
a
g
g
g
g
g
g
g
a
a
C
H
a
a
a
a
a
a
a
a
g
g
g
g
g
g
g
g
g
g
g
"}
(22,1,1) = {"
g
g
g
g
g
g
g
g
g
a
a
C
C
a
a
a
a
a
a
g
g
g
g
g
g
g
g
g
g
g
g
g
"}
(23,1,1) = {"
g
g
g
g
g
g
g
g
g
a
a
a
J
a
g
a
a
g
g
g
g
g
g
g
g
g
g
g
g
g
g
g
"}
(24,1,1) = {"
g
g
g
g
g
g
g
g
g
g
a
a
a
a
g
g
g
g
g
g
g
g
g
g
g
g
g
g
g
g
a
g
"}
(25,1,1) = {"
g
g
g
g
g
g
g
g
g
g
g
g
a
a
g
g
g
g
g
g
g
g
g
g
g
g
g
g
g
a
a
a
"}
(26,1,1) = {"
g
g
g
g
g
g
g
g
g
g
g
g
g
g
g
g
g
g
g
g
g
g
g
g
g
g
g
g
g
g
a
a
"}
(27,1,1) = {"
g
g
g
g
g
g
g
g
g
g
g
g
g
g
g
g
g
g
g
g
g
a
g
g
g
g
g
g
g
g
a
a
"}
(28,1,1) = {"
g
g
g
g
g
g
g
g
g
g
g
g
g
g
g
g
g
g
g
g
g
a
a
g
g
g
g
g
g
a
a
a
"}
(29,1,1) = {"
g
g
g
g
g
g
g
g
g
a
a
g
g
g
g
g
g
g
g
g
g
a
a
g
g
g
g
g
g
g
a
g
"}
(30,1,1) = {"
g
g
g
g
g
g
g
g
g
a
a
a
g
g
g
g
g
g
g
g
g
g
a
a
g
g
g
g
g
g
g
g
"}
(31,1,1) = {"
g
g
g
g
g
g
g
g
g
g
g
a
g
g
g
g
g
g
g
g
g
g
g
g
g
g
g
g
g
g
g
g
"}
(32,1,1) = {"
g
g
g
g
g
g
g
g
g
g
g
g
g
g
g
g
g
g
g
g
g
g
g
g
g
g
g
g
g
g
g
g
"}
