//MAP CONVERTED BY dmm2tgm.py THIS HEADER COMMENT PREVENTS RECONVERSION, DO NOT REMOVE
"a" = (
/turf/space,
/area/space)
"b" = (
/obj/shrub{
	dir = 6
	},
/turf/simulated/floor/grass/leafy,
/area/spacehabitat/owlery)
"c" = (
/turf/simulated/floor/caution/north,
/area/spacehabitat/owlery)
"f" = (
/turf/simulated/floor/grey,
/area/spacehabitat/owlery)
"g" = (
/turf/space/asteroid,
/area/space)
"h" = (
/turf/simulated/floor/shuttlebay,
/area/spacehabitat/owlery)
"i" = (
/obj/machinery/portableowl/attached{
	name = "Richelieu"
	},
/turf/simulated/floor/grass/leafy,
/area/spacehabitat/owlery)
"k" = (
/obj/machinery/r_door_control/podbay{
	id = "habitat_bay"
	},
/turf/simulated/wall/auto/jen/dark4,
/area/spacehabitat/owlery)
"l" = (
/obj/item/space_thing,
/turf/simulated/floor/caution/corner/misc{
	dir = 9
	},
/area/spacehabitat/owlery)
"n" = (
/obj/table/auto,
/obj/item/clothing/under/gimmick/owl,
/obj/item/clothing/under/gimmick/owl,
/obj/item/clothing/under/gimmick/owl,
/obj/item/clothing/mask/owl_mask,
/obj/item/clothing/mask/owl_mask,
/obj/item/clothing/mask/owl_mask,
/turf/simulated/floor/grass/leafy,
/area/spacehabitat/owlery)
"p" = (
/obj/shrub{
	dir = 8
	},
/turf/simulated/floor/grass/leafy,
/area/spacehabitat/owlery)
"q" = (
/obj/landmark/spawner/loot,
/turf/simulated/floor/plating/airless/asteroid/dark,
/area/spacehabitat/owlery)
"r" = (
/obj/tree,
/turf/simulated/floor/grass/leafy,
/area/spacehabitat/owlery)
"t" = (
/obj/machinery/door/airlock/pyro{
	dir = 4;
	name = "Owl Zone"
	},
/turf/simulated/floor,
/area/spacehabitat/owlery)
"u" = (
/turf/simulated/wall/auto/jen/green,
/area/spacehabitat/owlery)
"w" = (
/obj/machinery/door/poddoor/blast/pyro/podbay_autoclose{
	id = "habitat_bay";
	name = "pod bay (habitat)"
	},
/turf/simulated/floor/shuttlebay,
/area/spacehabitat/owlery)
"x" = (
/turf/simulated/wall/auto/jen/dark4,
/area/spacehabitat/owlery)
"y" = (
/obj/machinery/light/small{
	dir = 1;
	pixel_y = 21
	},
/turf/simulated/floor/grass/leafy,
/area/spacehabitat/owlery)
"z" = (
/obj/machinery/door/airlock/pyro/external{
	dir = 4;
	name = "Owl Zone Access"
	},
/obj/mapping_helper/airlock/cycler/manual{
	cycle_id = "owlrey";
	name = "Owlrey"
	},
/turf/simulated/floor/grey,
/area/spacehabitat/owlery)
"A" = (
/obj/machinery/door/airlock/pyro/external{
	name = "Owl Zone Access"
	},
/obj/mapping_helper/airlock/cycler/manual{
	cycle_id = "owlrey";
	name = "Owlrey"
	},
/turf/simulated/floor/caution/north,
/area/spacehabitat/owlery)
"B" = (
/obj/machinery/portableowl/attached{
	name = "A Pretty Owl"
	},
/turf/simulated/floor/grass/leafy,
/area/spacehabitat/owlery)
"C" = (
/obj/shrub{
	dir = 4
	},
/turf/simulated/floor/grass/leafy,
/area/spacehabitat/owlery)
"E" = (
/obj/machinery/light/small,
/turf/simulated/floor/caution/north,
/area/spacehabitat/owlery)
"H" = (
/obj/machinery/portableowl/attached{
	name = "L. Ron Hootabembe"
	},
/turf/simulated/floor/grass/leafy,
/area/spacehabitat/owlery)
"I" = (
/obj/shrub,
/turf/simulated/floor/grass/leafy,
/area/spacehabitat/owlery)
"J" = (
/obj/shrub{
	dir = 1
	},
/turf/simulated/floor/grass/leafy,
/area/spacehabitat/owlery)
"K" = (
/obj/machinery/light/small{
	dir = 4;
	pixel_x = 12
	},
/turf/simulated/floor/plating/airless/asteroid/dark,
/area/spacehabitat/owlery)
"N" = (
/turf/simulated/floor/grass/leafy,
/area/spacehabitat/owlery)
"P" = (
/obj/machinery/portableowl/attached{
	name = "Hans Owlo"
	},
/turf/simulated/floor/grass/leafy,
/area/spacehabitat/owlery)
"Q" = (
/turf/simulated/wall/auto/asteroid/dark,
/area/spacehabitat/owlery)
"R" = (
/turf/simulated/floor,
/area/spacehabitat/owlery)
"U" = (
/obj/machinery/portable_atmospherics/canister/air/large,
/obj/machinery/light/small,
/turf/simulated/floor,
/area/spacehabitat/owlery)
"V" = (
/obj/machinery/macrofab/emergency_pod{
	dir = 1;
	override_dir = 4
	},
/turf/simulated/floor/shuttlebay,
/area/spacehabitat/owlery)
"W" = (
/obj/machinery/portableowl/attached{
	name = "Owl-iver"
	},
/turf/simulated/floor/grass/leafy,
/area/spacehabitat/owlery)
"X" = (
/obj/machinery/door/airlock/pyro{
	dir = 4;
	name = "Owl Zone"
	},
/turf/simulated/floor/grass/leafy,
/area/spacehabitat/owlery)
"Y" = (
/turf/simulated/floor/caution/west,
/area/spacehabitat/owlery)
"Z" = (
/turf/simulated/floor/plating/airless/asteroid/dark,
/area/spacehabitat/owlery)

(1,1,1) = {"
a
a
a
a
a
a
a
a
a
a
a
a
a
a
a
a
a
a
a
a
a
a
a
a
a
a
a
a
a
a
a
a
"}
(2,1,1) = {"
a
a
a
a
a
a
a
a
a
a
a
a
a
a
a
a
a
a
a
a
a
a
a
a
a
a
a
a
a
a
a
a
"}
(3,1,1) = {"
a
a
a
a
a
a
a
a
Q
Q
a
a
a
a
a
a
a
a
a
a
a
a
a
a
a
a
a
a
a
a
a
a
"}
(4,1,1) = {"
a
a
a
a
a
a
a
Q
Q
Q
Q
Q
Q
Q
Q
a
a
a
a
a
a
a
a
a
a
a
a
a
a
a
a
a
"}
(5,1,1) = {"
a
a
a
a
a
a
a
Q
Q
Q
Q
Q
Q
Q
Q
Q
Q
Q
Q
a
a
a
a
a
a
a
a
a
a
a
a
a
"}
(6,1,1) = {"
a
a
a
a
a
a
a
Q
Q
Q
Q
Q
Q
Q
Q
Q
Q
Q
Q
Q
Q
a
a
a
a
a
a
a
a
a
a
a
"}
(7,1,1) = {"
a
a
a
a
a
a
Q
Q
Q
Q
Q
Q
Q
Q
Q
Q
Q
Q
Q
Q
Q
Q
a
a
a
a
a
a
a
a
a
a
"}
(8,1,1) = {"
a
a
a
a
a
Z
Z
Q
Q
Q
Q
Q
Q
Q
Q
Q
Q
Q
Q
Q
Q
Q
Q
a
a
a
a
a
a
a
a
a
"}
(9,1,1) = {"
a
a
a
a
Z
Z
Z
Z
Z
k
x
x
x
x
Q
Q
Q
Q
Q
Q
Q
Q
Q
a
a
a
a
a
a
a
a
a
"}
(10,1,1) = {"
a
a
a
Q
Z
Z
Z
Z
Z
w
h
h
E
x
Q
Q
Q
Q
Q
Q
Q
Q
Q
a
a
a
a
a
a
a
a
a
"}
(11,1,1) = {"
a
a
Q
Q
Q
Z
Z
Z
Z
w
h
h
c
x
Q
Q
Q
u
u
Q
Q
Q
Q
a
a
a
a
a
g
a
a
a
"}
(12,1,1) = {"
a
Q
Q
Q
Q
Z
Z
Z
Z
w
h
V
c
x
Q
Q
p
W
u
u
Q
Q
Q
Q
a
a
a
a
a
a
a
a
"}
(13,1,1) = {"
a
Q
Q
Q
Z
Z
Z
Z
Z
w
h
h
E
x
Q
u
N
N
N
u
Q
Q
Q
Q
a
a
a
a
a
a
a
a
"}
(14,1,1) = {"
a
Q
Q
Z
Z
Q
Z
K
Z
w
h
h
c
x
Q
u
N
N
i
u
Q
Q
Q
Q
Q
a
a
a
a
a
a
a
"}
(15,1,1) = {"
a
Q
Q
Z
Q
Q
Q
x
z
x
Y
Y
l
x
x
x
y
u
u
u
Q
Q
Q
Q
Q
a
a
a
a
a
a
a
"}
(16,1,1) = {"
a
Q
Q
Z
Q
Q
Q
x
f
A
R
R
U
x
Q
u
N
N
N
u
Q
Q
Q
Q
Q
a
a
a
a
a
a
a
"}
(17,1,1) = {"
a
a
Q
Z
Z
Z
Q
x
x
x
x
t
x
x
Q
u
N
N
r
Q
Q
Q
Q
Q
Q
a
a
a
a
a
a
a
"}
(18,1,1) = {"
a
a
Q
Q
Q
Z
Q
Q
Q
x
f
f
f
x
Q
u
N
N
N
Q
Q
Q
Q
Q
Q
a
a
a
a
a
a
a
"}
(19,1,1) = {"
a
a
a
Q
Q
Z
Z
Q
Q
u
u
X
u
u
u
u
I
N
N
N
Q
Q
Q
Q
Q
a
a
a
a
a
a
a
"}
(20,1,1) = {"
a
a
a
a
Q
Q
q
Q
Q
u
N
N
N
B
u
u
u
u
N
N
Q
Q
Q
Q
Q
a
a
a
a
a
a
a
"}
(21,1,1) = {"
a
a
a
a
Q
Q
Q
Q
Q
u
N
r
N
N
b
n
u
N
N
J
u
Q
Q
Q
Q
Q
a
a
a
a
a
a
"}
(22,1,1) = {"
a
g
a
a
a
Q
Q
Q
Q
u
N
N
N
N
N
N
N
N
N
H
u
Q
Q
Q
Q
Q
a
a
a
a
a
a
"}
(23,1,1) = {"
a
a
a
a
a
Q
Q
Q
Q
u
u
C
N
N
N
N
N
N
p
u
u
Q
Q
Q
Q
a
a
a
a
a
a
a
"}
(24,1,1) = {"
a
a
a
a
a
Q
Q
Q
Q
Q
u
N
N
J
u
u
u
u
u
u
Q
Q
Q
Q
Q
a
a
a
a
a
a
a
"}
(25,1,1) = {"
a
a
a
a
a
Q
Q
Q
Q
Q
u
N
N
u
u
Q
Q
Q
Q
Q
Q
Q
Q
Q
a
a
a
a
a
a
a
a
"}
(26,1,1) = {"
a
a
a
a
a
Q
Q
Q
Q
Q
N
N
r
u
Q
Q
Q
Q
Q
Q
Q
Q
Q
Q
a
a
a
a
a
a
a
a
"}
(27,1,1) = {"
a
a
a
a
Q
Q
Q
Q
Q
u
N
N
N
u
Q
Q
Q
Q
Q
Q
Q
Q
Q
Q
a
a
a
a
a
a
a
a
"}
(28,1,1) = {"
a
a
a
a
Q
Q
Q
Q
Q
u
p
P
Q
Q
Q
Q
Q
Q
Q
Q
Q
Q
Q
a
a
a
a
a
a
a
a
a
"}
(29,1,1) = {"
a
a
a
a
Q
Q
Q
Q
Q
u
u
Q
Q
Q
Q
Q
Q
Q
Q
Q
Q
a
a
a
a
a
a
g
a
a
a
a
"}
(30,1,1) = {"
a
a
a
a
a
Q
Q
Q
Q
Q
Q
Q
Q
Q
Q
Q
Q
Q
a
a
a
a
a
a
a
a
a
a
a
a
a
a
"}
(31,1,1) = {"
a
a
a
a
a
a
a
Q
Q
Q
Q
Q
Q
Q
Q
Q
a
a
a
a
a
a
a
a
a
a
a
a
a
a
a
a
"}
(32,1,1) = {"
a
a
a
a
a
a
a
a
Q
Q
Q
Q
Q
Q
a
a
a
a
a
a
a
a
a
a
a
a
a
a
a
a
a
a
"}
