//MAP CONVERTED BY dmm2tgm.py THIS HEADER COMMENT PREVENTS RECONVERSION, DO NOT REMOVE
"a" = (
/obj/machinery/power/solar/small_backup1,
/obj/cable/yellow{
	icon_state = "0-8"
	},
/turf/simulated/floor/airless{
	icon_state = "solarbase";
	name = "solar paneling"
	},
/area/station/solar/small_backup1)
"f" = (
/obj/rack,
/obj/item/clothing/suit/space/emerg,
/obj/item/clothing/head/emerg,
/obj/item/clothing/mask/breath,
/obj/item/tank/air,
/obj/item/device/light/flashlight,
/obj/machinery/light/incandescent/small,
/turf/simulated/floor/plating,
/area/station/maintenance/solar/alpha)
"g" = (
/obj/mapping_helper/wingrille_spawn/auto/reinforced,
/turf/simulated/floor/plating,
/area/station/maintenance/solar/alpha)
"i" = (
/obj/machinery/power/solar/small_backup1,
/obj/cable/yellow{
	icon_state = "0-4"
	},
/turf/simulated/floor/airless{
	icon_state = "solarbase";
	name = "solar paneling"
	},
/area/station/solar/small_backup1)
"j" = (
/obj/machinery/door/airlock/pyro/external{
	dir = 4
	},
/obj/cable/yellow{
	icon_state = "4-8"
	},
/obj/mapping_helper/access/engineering_power,
/obj/mapping_helper/airlock/cycler/manual{
	cycle_id = "solars1int";
	name = "Solars 1"
	},
/turf/simulated/floor/plating,
/area/station/maintenance/solar/alpha)
"m" = (
/obj/decal/poster/wallsign/space,
/turf/simulated/wall/auto/reinforced/supernorn/colored/yellow,
/area/station/maintenance/solar/alpha)
"n" = (
/obj/cable{
	icon_state = "1-2"
	},
/obj/disposalpipe/trunk/north,
/obj/machinery/disposal/small/west,
/turf/simulated/floor/plating,
/area/station/maintenance/solar/alpha)
"o" = (
/obj/mesh/catwalk{
	dir = 6
	},
/obj/cable/yellow,
/obj/cable/yellow{
	icon_state = "0-2"
	},
/obj/cable/yellow{
	icon_state = "0-4"
	},
/obj/cable/yellow{
	icon_state = "0-8"
	},
/turf/simulated/floor/airless/plating/catwalk/auto,
/area/station/solar/small_backup1)
"q" = (
/obj/cable{
	icon_state = "0-2"
	},
/obj/cable,
/obj/machinery/power/apc/autoname_east,
/obj/machinery/camera/directional/east{
	pixel_y = 10
	},
/obj/disposalpipe/segment/vertical,
/turf/simulated/floor/plating,
/area/station/maintenance/solar/alpha)
"r" = (
/obj/cable{
	icon_state = "1-2"
	},
/obj/cable{
	icon_state = "2-4"
	},
/obj/landmark/gps_waypoint,
/obj/disposalpipe/segment/bent/east,
/turf/simulated/floor/plating,
/area/station/maintenance/solar/alpha)
"s" = (
/turf/simulated/wall/auto/reinforced/supernorn/colored/yellow,
/area/station/maintenance/solar/alpha)
"t" = (
/obj/mesh/catwalk{
	dir = 6
	},
/obj/cable/yellow{
	icon_state = "0-4"
	},
/obj/cable/yellow{
	icon_state = "0-8"
	},
/obj/cable/yellow{
	icon_state = "0-2"
	},
/turf/simulated/floor/airless/plating/catwalk/auto,
/area/station/solar/small_backup1)
"v" = (
/obj/cable/yellow{
	icon_state = "0-2"
	},
/obj/machinery/computer/solar_control/small_backup1{
	dir = 4
	},
/turf/simulated/floor/plating,
/area/station/maintenance/solar/alpha)
"w" = (
/obj/machinery/door/airlock/pyro/engineering/alt{
	dir = 4
	},
/obj/cable{
	icon_state = "4-8"
	},
/obj/disposalpipe/segment/horizontal,
/obj/mapping_helper/access/engineering_power,
/obj/mapping_helper/firedoor_spawn,
/turf/simulated/floor/plating,
/area/station/maintenance/solar/alpha)
"x" = (
/obj/machinery/computer/power_monitor{
	name = "Station Power Grid Monitoring"
	},
/obj/cable{
	icon_state = "0-2"
	},
/obj/machinery/light/incandescent/small,
/turf/simulated/floor/plating,
/area/station/maintenance/solar/alpha)
"y" = (
/obj/table/reinforced/auto,
/obj/machinery/cell_charger,
/obj/item/cell/supercell/charged,
/obj/item/cell/supercell/charged,
/turf/simulated/floor/plating,
/area/station/maintenance/solar/alpha)
"A" = (
/obj/machinery/power/smes{
	chargelevel = 15000;
	output = 10000
	},
/obj/cable,
/turf/simulated/floor/plating,
/area/station/maintenance/solar/alpha)
"B" = (
/obj/machinery/power/terminal{
	dir = 4
	},
/obj/cable/yellow,
/obj/item/device/radio/intercom/engineering{
	dir = 4
	},
/turf/simulated/floor/plating,
/area/station/maintenance/solar/alpha)
"E" = (
/obj/mesh/catwalk{
	dir = 6
	},
/turf/simulated/floor/airless/plating/catwalk/auto,
/area/station/solar/small_backup1)
"G" = (
/obj/cable/yellow{
	icon_state = "2-8"
	},
/obj/cable/yellow{
	icon_state = "1-8"
	},
/turf/simulated/floor/plating,
/area/station/maintenance/solar/alpha)
"H" = (
/obj/mesh/catwalk{
	dir = 6
	},
/obj/cable/yellow{
	icon_state = "1-2"
	},
/turf/simulated/floor/airless/plating/catwalk/auto,
/area/station/solar/small_backup1)
"I" = (
/obj/machinery/power/tracker/small_backup1,
/obj/mesh/catwalk{
	dir = 6
	},
/obj/cable/yellow,
/turf/simulated/floor/airless/plating/catwalk/auto,
/area/station/solar/small_backup1)
"J" = (
/obj/mesh/catwalk{
	dir = 6
	},
/obj/cable/yellow{
	icon_state = "2-8"
	},
/turf/simulated/floor/airless/plating/catwalk/auto,
/area/station/solar/small_backup1)
"L" = (
/obj/cable/yellow{
	icon_state = "1-2"
	},
/obj/machinery/firealarm/directional/west,
/turf/simulated/floor/plating,
/area/station/maintenance/solar/alpha)
"M" = (
/obj/lattice{
	dir = 4;
	icon_state = "lattice-dir"
	},
/turf/space,
/area/space)
"N" = (
/turf/simulated/wall/auto/supernorn/colored,
/area/station/maintenance/solar/alpha)
"P" = (
/obj/mesh/catwalk{
	dir = 6
	},
/obj/cable/yellow,
/obj/cable/yellow{
	icon_state = "0-4"
	},
/obj/cable/yellow{
	icon_state = "0-8"
	},
/turf/simulated/floor/airless/plating/catwalk/auto,
/area/station/solar/small_backup1)
"Q" = (
/obj/mesh/catwalk{
	dir = 6
	},
/obj/cable/yellow,
/obj/cable/yellow{
	icon_state = "0-4"
	},
/obj/cable/yellow{
	icon_state = "0-8"
	},
/obj/cable/yellow{
	icon_state = "0-2"
	},
/turf/simulated/floor/airless/plating/catwalk/auto,
/area/station/solar/small_backup1)
"R" = (
/obj/cable/yellow{
	icon_state = "1-4"
	},
/turf/simulated/floor/plating,
/area/station/maintenance/solar/alpha)
"S" = (
/obj/cable/yellow{
	icon_state = "1-2"
	},
/obj/machinery/light/incandescent/small,
/turf/simulated/floor/plating,
/area/station/maintenance/solar/alpha)
"T" = (
/turf/space,
/area/space)
"W" = (
/obj/cable{
	icon_state = "1-2"
	},
/obj/stool/chair/yellow{
	dir = 8
	},
/obj/machinery/light_switch/directional/east,
/turf/simulated/floor/plating,
/area/station/maintenance/solar/alpha)
"X" = (
/obj/mesh/catwalk{
	dir = 6
	},
/obj/cable/yellow{
	icon_state = "4-8"
	},
/turf/simulated/floor/airless/plating/catwalk/auto,
/area/station/solar/small_backup1)
"Y" = (
/obj/machinery/door/airlock/pyro/external,
/obj/cable/yellow{
	icon_state = "1-2"
	},
/obj/mapping_helper/airlock/cycler/manual{
	cycle_id = "solars1ext";
	name = "Solars 1"
	},
/turf/simulated/floor/plating,
/area/station/maintenance/solar/alpha)
"Z" = (
/obj/mesh/catwalk{
	dir = 6
	},
/obj/cable/yellow,
/obj/cable/yellow{
	icon_state = "0-2"
	},
/obj/cable/yellow{
	icon_state = "0-4"
	},
/turf/simulated/floor/airless/plating/catwalk/auto,
/area/station/solar/small_backup1)

(1,1,1) = {"
T
T
T
T
T
T
T
T
T
T
T
T
T
T
T
"}
(2,1,1) = {"
T
i
i
i
i
i
E
i
i
i
i
i
T
T
T
"}
(3,1,1) = {"
T
t
Q
Q
Q
Q
Z
Q
Q
Q
Q
Q
H
I
T
"}
(4,1,1) = {"
T
a
a
a
a
a
X
a
a
a
a
a
T
T
T
"}
(5,1,1) = {"
T
M
T
T
T
T
X
T
T
T
T
M
T
T
T
"}
(6,1,1) = {"
T
i
i
i
i
i
X
i
i
i
i
i
T
T
T
"}
(7,1,1) = {"
T
t
Q
Q
Q
Q
o
Q
Q
Q
Q
P
T
T
T
"}
(8,1,1) = {"
T
a
a
a
a
a
X
a
a
a
a
a
T
T
T
"}
(9,1,1) = {"
T
T
M
T
T
T
X
T
T
T
M
T
T
T
T
"}
(10,1,1) = {"
T
T
M
T
T
T
X
m
g
g
s
T
T
T
T
"}
(11,1,1) = {"
T
T
M
T
T
T
J
Y
R
f
s
T
T
T
T
"}
(12,1,1) = {"
T
T
M
T
g
g
g
s
j
s
s
s
T
T
T
"}
(13,1,1) = {"
T
T
M
T
g
y
v
L
G
S
B
s
T
T
T
"}
(14,1,1) = {"
T
T
M
T
s
x
W
r
q
n
A
s
T
T
T
"}
(15,1,1) = {"
N
g
g
g
s
s
s
w
s
s
s
s
N
N
N
"}
